cigar	雪茄
sissy	娘娘腔
humph	哼
awake	醒着的
blush	脸红
focal	焦
evade	逃避
naval	海军
serve	服务
heath	希斯
dwarf	矮
model	模型
karma	业力
stink	臭
grade	年级
quiet	安静的
bench	板凳上
abate	减弱
feign	假装
major	主要
death	死亡
fresh	新鲜的
crust	地壳
stool	凳子
colon	结肠
abase	自卑
marry	结婚
react	反应
batty	古怪的
pride	骄傲
floss	牙线
helix	螺旋
croak	用嘶哑的声音
staff	工作人员
paper	纸
unfed	得不到支持的
whelp	幼兽
trawl	用拖网捕鱼
outdo	超越
crazy	疯狂的
sower	撒种
repay	偿还
digit	数字
crate	箱
cluck	咯咯的叫声
spike	斯派克
mimic	模仿
pound	英镑
maxim	格言
linen	亚麻
unmet	未满足的
flesh	肉
booby	成绩最差的人
forth	出来
first	第一个
stand	站
belly	肚子
ivory	象牙
seedy	破烂的
print	打印
yearn	向往
drain	排水
bribe	贿赂
stout	结实的
panel	面板
crass	粗鲁的
flume	水槽
offal	内脏
agree	同意
error	错误
swirl	漩涡
argue	认为
bleed	流血
flick	电影
totem	图腾
wooer	求爱者
front	前面
shrub	灌木
parry	帕里
biome	生物群落
lapel	翻领
start	开始
greet	问候
goner	落魄的人
golem	傀儡
lusty	精力充沛的
loopy	呆头呆脑的
round	轮
audit	审计
lying	说谎
gamma	γ
labor	劳动
islet	胰岛
civic	公民
forge	打造
corny	陈腔滥调
basic	基本
salad	沙拉
agate	玛瑙
spicy	辣的
spray	喷雾
essay	文章
fjord	峡湾
spend	花
kebab	烤肉串
guild	公会
aback	吓
motor	电动机
alone	独自一人
hatch	孵化
hyper	超
thumb	拇指
dowry	嫁妆
ought	应该
belch	打嗝
dutch	荷兰
pilot	飞行员
tweed	斜纹软呢
comet	彗星
jaunt	短途旅游
enema	灌肠
steed	骏马
abyss	深渊
growl	咆哮
fling	舞
dozen	打
boozy	嗜酒的
erode	侵蚀
world	世界
gouge	圆凿
click	点击
briar	布瑞尔·罗
great	伟大的
altar	坛
pulpy	泥状的
blurt	突然说出
coast	海岸
duchy	公国
groin	腹股沟
group	集团
rogue	流氓
badly	严重
smart	聪明的
pithy	简洁有力的
gaudy	俗丽的
chill	寒冷
heron	鹭
vodka	伏特加
finer	细
surer	可靠
radio	广播
perch	鲈鱼
retch	恶心
wrote	写了
clock	时钟
tilde	波浪号
store	商店
prove	证明
bring	带
solve	解决
cheat	作弊
grime	污垢
exult	欢乐
usher	开启
epoch	时代
triad	三合会
break	打破
rhino	犀牛
viral	病毒
conic	二次曲线
sonic	声波
vital	至关重要的
trace	跟踪
using	使用
peach	桃子
baton	接力棒
brake	刹车
pluck	摘下
craze	狂热
weary	疲惫的
picky	挑剔的
acute	急性
ferry	渡船
aside	一边
tapir	貘
troll	巨魔
unify	统一
rebus	字谜
boost	提高
truss	桁架
siege	围攻
tiger	老虎
slump	衰退
crank	曲柄
query	查询
drink	喝
abbey	修道院
tangy	有刺激性的
panic	恐慌
solar	太阳能
shire	夏尔
proxy	代理
point	点
robot	机器人
prick	刺痛
wince	脸部肌肉的抽搐
crimp	褶
knoll	诺尔
sugar	糖
whack	不正常
mount	山
perky	活泼的
could	可以
wrung	拧
light	光
those	那些
moist	潮湿的
shard	碎片
pleat	褶
aloft	在空中
skill	技能
elder	老
frame	框架
humor	幽默
pause	暂停
ulcer	溃疡
ultra	超
robin	罗宾
cynic	愤世嫉俗者
aroma	香气
caulk	捻缝
shake	摇
pupal	蛹的
dodge	道奇
swill	泔水
tacit	隐性
other	其他
thorn	刺
trove	宝库
bloke	家伙
vivid	生动的
spill	泄漏
choke	窒息
rupee	卢比
nasty	令人讨厌的
mourn	哀悼
ahead	之前
brine	盐水
cloth	布
hoard	囤积
sweet	甜蜜的
month	月
lapse	失效
watch	看
today	今天
focus	焦点
smelt	胡瓜鱼
tease	取笑
cater	满足
movie	电影
lynch	林奇
allow	允许
renew	更新
their	他们的
slosh	泼
chest	胸部
depot	得宝
epoxy	环氧树脂
nymph	美丽的少女
found	发现
shall	应
harry	哈利
stove	炉子
lowly	卑微的
snout	鼻子
trope	比喻
fewer	更少的
shawl	披肩
fibre	纤维
comma	逗号
foray	尝试
scare	恐慌
stair	楼梯
black	黑色的
squad	队
royal	皇家
chunk	块
mince	矫揉做作地说
slave	奴隶
shame	羞愧
cheek	脸颊
ample	充足的
oxide	氧化
plant	植物
olive	橄榄
inert	惰性
askew	歪斜的
heist	抢劫
shown	所示
zesty	兴致很高的
hasty	匆忙的
trash	垃圾
fella	小伙子
forgo	放弃
story	故事
hairy	多毛的
train	火车
homer	荷马
badge	徽章
midst	中间
canny	精明的
fetus	胎儿
butch	布奇
farce	闹剧
slung	挂
tipsy	醉了
metal	金属
yield	收益率
delve	深入研究
being	被
scour	冲刷
glass	玻璃
scrap	废
money	钱
hinge	铰链
album	专辑
vouch	担保
asset	资产
tiara	头饰
crept	爬
bayou	河口
atoll	环礁
manor	庄园
creak	嘎吱嘎吱声
showy	艳丽的
phase	阶段
froth	泡沫
depth	深度
gloom	忧郁
flood	洪水
girth	周长
piety	虔诚
goose	鹅
float	浮动
donor	捐赠
atone	赎罪
apron	围裙
blown	吹
cacao	可可
loser	失败者
input	输入
gloat	幸灾乐祸
awful	可怕的
brink	边缘
smite	击杀
beady	起泡的
rusty	生锈的
retro	复古的
droll	滑稽可笑的人
gawky	笨拙的人
hutch	厨
gaily	快乐地
egret	白鹭
lilac	淡紫色
sever	切断
field	场
fluff	绒毛
hydro	水电
flack	长颈瓶
agape	神
wench	姑娘
voice	的声音
stead	代替
stalk	茎
berth	泊位
madam	夫人
night	晚上
bland	平淡无奇
liver	肝
wedge	楔
augur	预示着
roomy	宽敞的
wacky	古怪的
flock	群
angry	愤怒的
bobby	鲍比
trite	老套的
aphid	蚜虫
tryst	幽会
midge	蚊
power	权力
elope	私奔
cinch	有把握的事情
motto	的座右铭
stomp	跺脚
upset	心烦意乱
bluff	虚张声势
cramp	抽筋
coyly	害羞地
youth	青年
rhyme	押韵
buggy	车
alien	外星人
smear	涂片
unfit	不称职的
patty	帕蒂
cling	抓住
glean	收集
label	标签
hunky	匈牙利人
khaki	卡其色
poker	扑克
gruel	粥
twice	两次
twang	鼻音
shrug	耸耸肩
treat	治疗
unlit	不发光的
waste	浪费
merit	优点
woven	编织
octal	八进制
needy	有需要的
clown	小丑
widow	寡妇
irony	具有讽刺意味的
ruder	粗鲁的
gauze	纱布
chief	首席
onset	发病
prize	奖
fungi	真菌
charm	魅力
gully	沟
whoop	大叫
taunt	嘲讽
leery	狡猾的
class	类
theme	主题
lofty	崇高的
booze	酒
alpha	α
thyme	百里香
eclat	辉煌的成就
doubt	怀疑
stick	坚持
trice	瞬间
alike	都
sooth	真实的
recap	回顾
saint	圣
liege	列日
glory	荣耀
grate	炉篦
admit	承认
brisk	轻快的
soggy	沉闷的
usurp	篡夺
scald	烫伤
scorn	嘲笑
leave	离开
twine	线
sting	刺痛
bough	大树枝
marsh	沼泽
sloth	懒惰
dandy	花花公子
vigor	活力
howdy	你好
enjoy	享受
valid	有效的
ionic	离子
equal	平等的
unset	设置
floor	地板上
catch	抓
spade	铲
stein	斯坦
exist	存在
quirk	怪癖
denim	牛仔布
grove	格罗夫
spiel	演奏音乐
mummy	木乃伊
fault	的错
foggy	多雾的
flout	无视
carry	携带
sneak	偷偷摸摸的行为
libel	诽谤
waltz	华尔兹
aptly	恰当地
piney	似松的
inept	无能的
aloud	大声
photo	照片
dream	梦想
stale	不新鲜的
vomit	呕吐物
unite	团结起来
snarl	咆哮
baker	贝克
there	在那里
glyph	字形
hippy	嬉皮士
spell	拼写
folly	愚蠢
louse	虱子
gulch	峡谷
vault	库
godly	敬神的
threw	扔了
fleet	舰队
grave	坟墓
inane	空洞的
shock	冲击
crave	渴望
spite	尽管
valve	阀
skimp	吝啬
claim	索赔
rainy	多雨的
musty	发霉的
daddy	爸爸
arise	出现
aging	老化
opium	鸦片
avert	避免
stuck	卡住了
recut	再切
mulch	覆盖物
rifle	步枪
count	数
incur	承担
total	总计
wrest	夺取
study	研究
lover	情人
safer	更安全的
rivet	铆钉
funny	有趣的
smoke	烟
mound	丘
undue	过度的
sedan	轿车
swine	猪
guile	诡计
gusty	突发的
equip	装备
tough	艰难的
canoe	独木舟
chaos	混乱
covet	觊觎
human	人类
udder	乳房
lunch	午餐
blast	爆炸
stray	流浪
manga	漫画
melee	近战
lefty	左撇子
quick	快速
paste	粘贴
given	鉴于
octet	八隅体
risen	上升
groan	呻吟
leaky	漏水的
grind	磨
carve	雕刻
loose	宽松的
sadly	可悲的是
spilt	洒出的
apple	苹果
slack	松弛
honey	蜂蜜
final	最后
sheen	辛
eerie	怪异的
minty	有薄荷味的
slick	浮油
derby	德比
wharf	码头
spelt	拼写
coach	教练
erupt	爆发
price	价格
spawn	产卵
fairy	仙女
jiffy	瞬间
filmy	朦胧的
stack	堆栈
sleep	睡眠
nanny	保姆
niece	侄女
woozy	头昏眼花的
handy	方便的
grace	格蕾丝
ditto	同上
stank	发出恶臭
cream	奶油
usual	通常
diode	二极管
angle	角
ninja	忍者
muddy	泥泞的
chase	追逐
reply	回复
prone	倾向
spoil	破坏
heart	心
shade	阴影
diner	用餐者
arson	纵火
onion	洋葱
sleet	雨夹雪
dowel	销
couch	沙发上
palsy	麻痹
bowel	肠
smile	微笑
evoke	唤起
creek	溪
lance	兰斯
eagle	鹰
idiot	白痴
siren	塞壬
built	建
embed	嵌入
award	奖
dross	渣滓
annul	取消
goody	古蒂
frown	皱眉
patio	天井
laden	拉登
humid	潮湿的
elite	精英
lymph	淋巴
edify	陶冶
might	可能
reset	重置
visit	访问
purse	钱包
vapor	蒸汽
crock	缸
write	写
sunny	阳光明媚的
loath	不
chaff	糠
slide	幻灯片
queer	酷儿
venom	毒液
stamp	邮票
sorry	对不起
still	仍然
acorn	橡子
aping	模仿
pushy	有进取心的
hater	怀恨者
mania	躁狂
awoke	醒来
brawn	发达的肌肉
swift	斯威夫特
exile	流亡
birch	桦木
lucky	幸运的
freer	更自由的
risky	有风险的
ghost	鬼
lunar	月球
winch	绞车
snare	陷阱
nurse	护士
house	房子
borax	硼砂
nicer	更好的
lurch	倾斜
exalt	高举
about	关于
savvy	精明的
toxin	毒素
tunic	束腰外衣
pried	探究
inlay	镶嵌
chump	笨蛋
lanky	瘦长的
cress	水芹
eater	吃
elude	躲避
cycle	周期
kitty	基蒂
moron	白痴
tenet	宗旨
place	的地方
lobby	游说团体
plush	豪华的
vigil	守夜
index	指数
blink	眨眼
clung	在
qualm	疑虑
croup	臀部
clink	发出叮当声
juicy	多汁的
stage	阶段
decay	衰变
nerve	神经
flier	广告传单
shaft	轴
crook	骗子
clean	清洁
china	中国
ridge	脊
vowel	元音
snuck	偷偷
icing	糖衣
spiny	多刺的
rigor	严格
snail	蜗牛
flown	飞
rabid	患狂犬病的
prose	散文
thank	谢谢
poppy	罂粟
budge	让步
fiber	纤维
moldy	发霉的
dowdy	懒散的女人
kneel	跪
track	跟踪
caddy	球童
quell	平息
dumpy	矮胖的
paler	苍白
swore	发誓
rebar	钢筋
scuba	潜水
splat	长条木板
flyer	摩天观景轮
horny	角质
mason	梅森
doing	做
ozone	臭氧
amply	充分
ovary	卵巢
beset	困扰
queue	队列
cliff	悬崖
magic	魔法
truce	停火协议
sport	体育运动
fritz	弗里茨
edict	法令
twirl	旋转的东西
verse	节
eaten	吃
range	范围
whisk	搅拌
hovel	小屋
rehab	康复中心
macaw	金刚鹦鹉
sigma	σ
spout	滔滔不绝地讲
sushi	寿司
dying	死亡
fetid	恶臭的
brain	大脑
buddy	好友
thump	砰地撞到
scion	接穗
candy	糖果
chord	和弦
basin	盆地
march	3月
crowd	人群
arbor	阿伯
gayly	快乐地
musky	麝香的
stain	染色
dally	轻率地对待
bless	祝福
stung	刺痛
title	标题
ruler	统治者
kiosk	亭
blond	金发碧眼的
layer	层
fluid	流体
tatty	不值钱的
score	分数
cutie	漂亮的女孩
zebra	斑马
barge	驳船
matey	友好的
bluer	更蓝
shook	摇了摇
river	河
privy	有利害关系的人
betel	槟榔
frisk	快乐的时刻
bongo	邦戈
begun	开始
weave	织
genie	精灵
sound	声音
glove	手套
braid	编织
scope	范围
wryly	挖苦地
rover	探测器
assay	分析
ocean	海洋
bloom	布鲁姆
irate	愤怒的
later	晚些时候
rebut	反驳
adobe	土砖
delta	希腊字母表的第4个字母
moult	蜕皮
fixer	修理工
rouge	胭脂
masse	全体
champ	咀嚼
gripe	抱怨
banal	平庸的
gorge	峡
favor	赞成
agora	现在
chant	咏唱
saute	炒
purge	净化
natal	出生的
flair	天资
foyer	门厅
cargo	货物
larva	幼虫
gamer	玩家
trait	特质
payer	付款人
primo	普里莫
pinto	平托
quart	夸脱
inter	埋葬
tibia	胫骨
parer	帕勒
chute	溜槽
ombre	阴影
fanny	屁股
pooch	狗狗
pique	恼怒
quasi	准
valet	男仆
genre	体裁
plume	一缕
mocha	摩卡
deter	制止
pagan	异教徒
singe	烧焦
chose	选择
ardor	热情
valor	英勇
gusto	热情
tamer	驯服者
plier	弯曲
boule	布勒
gnome	侏儒
molar	臼齿
llama	火焰
verve	神韵
bravo	好极了
ennui	无聊
aider	帮助
azure	蔚蓝色的
woken	醒来
silky	丝一样的
wreck	沉船
dwelt	居住
slate	石板
smack	掴
solid	固体
amaze	令人惊奇
hazel	榛子
wrist	手腕
jolly	愉快的
globe	地球
flint	打火石
rouse	唤醒
civil	公民的
vista	远景
relax	放松
cover	掩蔽
alive	活着的
beech	山毛榉
jetty	码头
bliss	幸福
vocal	嗓音的
often	经常
dolly	多莉
eight	八
joker	小丑
since	自从
event	事件
ensue	接踵而至
shunt	移走
diver	潜水员
poser	难题
worst	最差的
sweep	打扫
alley	小巷
creed	信条
anime	动漫
leafy	枝繁叶茂
bosom	怀抱
dunce	笨蛋
stare	盯着看
pudgy	矮胖的
waive	放弃
choir	唱诗班
stood	站立
spoke	说话
outgo	支出
delay	延迟
bilge	舱底
ideal	完美的
clasp	扣环
seize	抓住
hotly	激动地
laugh	笑
sieve	滤器
block	块
meant	意味
grape	葡萄
noose	套索
hardy	能吃苦耐劳的
shied	惊退
drawl	慢吞吞地说
daisy	雏菊
putty	油灰
strut	趾高气昂地走
burnt	烧焦
tulip	郁金香
crick	克里克
idyll	田园诗
vixen	毒蛇
furor	狂怒
geeky	极客
cough	咳嗽
naive	缺乏经验的
shoal	鱼群
stork	鹳
bathe	洗澡
aunty	阿姨
check	检查
prime	首要的
brass	黄铜
outer	外面的
furry	毛茸茸的
razor	剃须刀
elect	选举
evict	驱逐
imply	意味着
demur	异议
quota	定额
haven	港口
cavil	无端抱怨
swear	发誓
crump	面包屑
dough	面团
gavel	木槌
wagon	马车
salon	沙龙
nudge	轻推
harem	后宫
pitch	抛
sworn	宣誓
pupil	学生
excel	擅长
stony	多石的
cabin	小屋
unzip	解开拉链
queen	女王
trout	鳟鱼
polyp	息肉
earth	世界
storm	暴风雨
until	直到
taper	变尖
enter	进来
child	小孩
adopt	采用
minor	少数的
fatty	富含脂肪的
husky	深沉沙哑的
brave	勇敢的
filet	鱼片
slime	粘液
glint	闪烁
tread	踩
steal	偷
regal	帝王的
guest	客人
every	每一个
murky	阴暗的
share	共有
spore	孢子
hoist	升起
buxom	丰满的
inner	内部的
otter	水獭
dimly	朦胧地
level	数量
sumac	漆树
donut	甜甜圈
stilt	高跷
arena	竞技场
sheet	床单
scrub	刷洗
fancy	设想
slimy	粘糊糊的
pearl	珍珠
silly	愚蠢的
porch	门廊
dingo	野狗
sepia	乌贼墨
amble	慢跑
shady	背阴的
bread	面包
friar	修士
reign	统治
dairy	乳品的
quill	羽毛笔
cross	交叉
brood	育雏
tuber	块茎
shear	剪羊毛
posit	假定
blank	空白的
villa	别墅
shank	长柄
piggy	小猪
freak	怪胎
which	哪一个
among	在…之间
fecal	粪便
shell	壳
would	将
algae	藻类
large	大的
rabbi	拉比
agony	极大的痛苦
amuse	娱乐
bushy	浓密的
copse	丛林
swoon	昏厥
knife	刀
pouch	小袋
ascot	阿斯科特
plane	飞机
crown	王冠
urban	城市的
snide	讽刺的
relay	转发
abide	遵守
viola	中提琴
rajah	国王
straw	稻草
dilly	迪利
crash	崩溃
amass	聚积
third	第三
trick	戏法
tutor	家庭教师
woody	伍迪
blurb	简介
grief	悲伤
disco	迪斯科
where	哪里
sassy	时髦的
beach	海滩
sauna	桑拿
comic	漫画
clued	抓住
creep	爬行
caste	种姓
graze	吃草
snuff	鼻烟
frock	连衣裙
gonad	性腺
drunk	醉的
prong	叉子
lurid	恐怖的
steel	钢
halve	减半
buyer	买主
vinyl	乙烯基
utile	有用的
smell	气味
adage	谚语
worry	担心
tasty	美味的
local	地方的
trade	贸易
finch	雀科小鸟
ashen	苍白的
modal	情态动词
gaunt	憔悴的
clove	丁香
enact	通过
adorn	装饰
roast	烤
speck	斑点
sheik	酋长
missy	米西
grunt	咕哝
snoop	窥探
party	政党
touch	触摸
mafia	黑手党
emcee	主持人
array	大堆
south	南方
vapid	乏味的
jelly	果冻
skulk	躲藏
angst	焦虑
tubal	输卵管的
lower	降低
crest	山顶
sweat	汗水
cyber	网络
adore	崇拜
tardy	迟缓的
swami	斯瓦米
notch	缺口
groom	新郎
roach	蟑螂
hitch	搭便车
young	幼小的
align	排列
ready	准备好的
frond	叶
strap	带子
puree	果泥
realm	领域
venue	地点
swarm	一大群
offer	提供
seven	七
dryer	烘干机
diary	记事簿
dryly	干巴巴的
drank	喝
acrid	辛辣的
heady	令人兴奋的
theta	西塔
junto	君托
pixie	小精灵
quoth	引用
bonus	奖金
shalt	将
penne	笔
amend	修正
datum	资料
build	建筑
piano	钢琴
shelf	架子
lodge	乡间小屋
suing	起诉
rearm	重新武装
coral	珊瑚
ramen	窗户
worth	值得的
psalm	诗篇
infer	推断
overt	公开的
mayor	市长
ovoid	卵形的
glide	滑行
usage	用法
poise	沉着自信
randy	兰迪
chuck	扔出
prank	玩笑
fishy	可疑的
tooth	牙齿
ether	乙醚
drove	开车
idler	惰轮
swath	斯瓦特
stint	吝啬
while	虽然
begat	生
apply	申请
slang	俚语
tarot	塔罗牌
radar	雷达
credo	信条
aware	意识到的
canon	原则
shift	转移
timer	计时器
bylaw	规章制度
serum	血清
three	三
steak	牛排
iliac	髂骨的
shirk	逃避
blunt	迟钝的
puppy	小狗
penal	刑罚的
joist	托梁
bunny	兔子
shape	形状
beget	导致
wheel	轮
adept	内行的
stunt	特技
stole	偷
topaz	黄玉
chore	家务活
fluke	侥幸
afoot	正在进行
bloat	膨胀
bully	恐吓
dense	稠密的
caper	跳跃
sneer	嘲笑
boxer	拳击手
jumbo	巨无霸
lunge	猛冲
space	空间
avail	效用
short	短的
slurp	发出啧啧的声音
loyal	忠诚的
flirt	调情
pizza	披萨
conch	海螺
tempo	速度
droop	下垂
plate	盘子
bible	圣经
plunk	扑通一声
afoul	冲突的
savoy	萨沃伊
steep	陡的
agile	敏捷的
stake	桩
dwell	居住
knave	无赖
beard	胡须
arose	出现
motif	动机
smash	粉碎
broil	烤
glare	怒目而视
shove	推
baggy	宽松的
mammy	奶妈
swamp	沼泽
along	沿着
rugby	橄榄球
wager	打赌
quack	江湖郎中
squat	蹲下
snaky	努力
debit	借记
mange	马槽
skate	滑冰
ninth	第九
joust	格斗
tramp	流浪汉
spurn	拒绝
medal	奖章
micro	微型的
rebel	背叛
flank	侧面
learn	学
nadir	最低点
maple	枫树
comfy	舒适的
remit	汇款
gruff	粗暴的
ester	酯
least	最小的
mogul	大亨
fetch	取来
cause	原因
oaken	橡树
aglow	发红
meaty	多肉的
gaffe	失礼
shyly	羞怯地
racer	赛车手
prowl	潜行
thief	贼
stern	船尾
poesy	诗歌
rocky	多石的
tweet	推特
waist	腰
spire	尖顶
grope	摸索
havoc	灾害
patsy	帕西
truly	真正地
forty	四十
deity	神
uncle	叔叔
swish	沙沙声
giver	给予者
preen	精心修饰
bevel	斜面
lemur	狐猴
draft	草稿
slope	斜坡
annoy	惹恼
lingo	术语
bleak	凄凉的
ditty	小调
curly	卷曲的
cedar	雪松
dirge	哀歌
grown	成年的
horde	部落
drool	流口水
shuck	脱壳
crypt	地窖
cumin	孜然
stock	股票
gravy	肉汁
locus	发生地
wider	更广的
breed	繁殖
quite	相当地
chafe	擦痛
cache	隐藏物
blimp	小型软皮艇
deign	屈尊
fiend	恶魔
logic	思维方式
cheap	花钱少的
elide	伊莱德
rigid	固执的
false	错误的
renal	肾的
pence	便士
rowdy	吵闹的
shoot	射击
blaze	火焰
envoy	特使
posse	一群
brief	简明的
never	从不
abort	中止
mouse	老鼠
mucky	肮脏的
sulky	生闷气的
fiery	火一般的
media	媒体
trunk	大旅行箱
yeast	酵母
clear	清楚的
skunk	臭鼬
scalp	头皮
bitty	比特
cider	苹果汁
koala	树袋熊
duvet	羽绒被
segue	塞格
creme	乳酪
super	超级的
grill	烤架
after	之后
owner	物主
ember	余烬
reach	达到
nobly	高贵的
empty	空的
speed	速度
gipsy	吉卜赛人
recur	重现
smock	工作服
dread	恐惧
merge	合并
burst	爆发
kappa	卡帕
amity	和睦
shaky	摇摇欲坠的
hover	悬停
carol	颂歌
snort	用鼻子哼哼
synod	会议
faint	昏倒
haunt	困扰
flour	面粉
chair	椅子
detox	排毒
shrew	悍妇
tense	紧张的
plied	使用
quark	夸克
burly	结实的
novel	小说
waxen	蜡质的
stoic	坚忍的
jerky	急促而不流畅的
blitz	闪电战
beefy	强壮的
lyric	抒情的
hussy	娘娘腔
towel	毛巾
quilt	被子
below	在下面
bingo	答对 了
wispy	纤细的
brash	自以为是的
scone	烤饼
toast	干杯
easel	画架
saucy	俏皮的
value	价值
spice	香料
honor	荣誉
route	路线
sharp	锋利的
bawdy	说黄色笑话的
radii	半径
skull	颅骨
phony	伪造的
issue	问题
lager	啤酒
swell	膨胀
urine	尿
gassy	瓦斯
trial	试验
flora	植物群
upper	上面的
latch	门闩
wight	怀特
brick	砖
retry	重试
holly	冬青
decal	贴花
grass	草
shack	简陋的小屋
dogma	教义
mover	搬运工
defer	推迟
sober	未醉
optic	视觉的
crier	叫喊者
vying	竞争
nomad	游牧民族
flute	长笛
hippo	河马
shark	鲨鱼
drier	干燥器
obese	肥胖的
bugle	号角声
tawny	茶色的
chalk	粉笔
feast	盛宴
ruddy	红润的
pedal	踏板
scarf	围巾
cruel	残酷的
bleat	咩咩叫
tidal	潮汐的
slush	泥浆
semen	精液
windy	多风的
dusty	尘土飞扬
sally	俏皮话
igloo	雪块砌成的圆顶小屋
nerdy	书呆子
jewel	珠宝
shone	闪耀
whale	鲸鱼
hymen	处女膜
abuse	滥用
fugue	赋格曲
elbow	肘部
crumb	面包屑
pansy	三色堇
welsh	威尔士的
syrup	糖水
terse	简短生硬的
suave	世故的
gamut	全范围
swung	摆动
drake	公鸭
freed	释放
afire	着火
shirt	衬衫
grout	薄泥浆
oddly	奇怪地
tithe	什一税
plaid	格子呢
dummy	笨蛋
broom	扫把
blind	失明的
torch	手电筒
enemy	敌人
again	再一次
tying	捆绑
pesky	讨厌的
alter	改变
gazer	凝视者
noble	高尚的
ethos	风气
bride	新娘
extol	歌颂
decor	装饰
hobby	爱好
beast	野兽
idiom	习语
utter	说
these	这些
sixth	第六
alarm	惊恐
erase	擦除
elegy	挽诗
spunk	勇气
piper	风笛手
scaly	有鳞屑的
scold	责骂
hefty	巨大的
chick	小鸡
sooty	乌黑的
canal	运河
whiny	发牢骚
slash	斜线
quake	发抖
joint	共同的
swept	扫
prude	谈性色变者
heavy	重的
wield	挥舞
femme	女人
lasso	套索
maize	玉米
shale	页岩
screw	螺丝钉
spree	狂欢
smoky	烟雾弥漫
whiff	一点儿气味
scent	气味
glade	林间空地
spent	花费
prism	棱镜
stoke	激起
riper	成熟的
orbit	轨道
cocoa	热可可
guilt	内疚
humus	腐殖质
shush	嘘
table	桌子
smirk	傻笑
wrong	错误的
noisy	吵闹的
alert	警觉的
shiny	闪亮的
elate	兴高采烈
resin	树脂
whole	整体
hunch	预感
pixel	像素
polar	极地的
hotel	酒店
sword	剑
cleat	夹板
mango	芒果
rumba	伦巴
puffy	浮肿的
filly	雌马
billy	比利
leash	皮带
clout	影响力
dance	跳舞
ovate	卵形
facet	方面
chili	辣椒
paint	油漆
liner	邮轮
curio	古董
salty	咸咸的
audio	音频
snake	蛇
fable	寓言
cloak	斗篷
navel	肚脐
spurt	喷发
pesto	香蒜酱
balmy	温和的
flash	闪光
unwed	未婚
early	早期的
churn	搅动
weedy	杂草
stump	树墩
lease	租赁
witty	言辞诙谐的
wimpy	懦弱的
spoof	恶作剧
saner	桑斯
blend	混合
salsa	萨尔萨
thick	厚的
warty	疣
manic	躁狂的
blare	发出响亮而刺耳的声音
squib	哑炮
spoon	勺子
probe	探查
crepe	绉纱
knack	技能
force	武力
debut	首次亮相
order	顺序
haste	急速
teeth	牙齿
agent	代理人
widen	拓宽
icily	冷冰冰的
slice	片
ingot	铸块
clash	冲突
juror	陪审团成员
blood	血
abode	住所
throw	投
unity	团结一致
pivot	支点
slept	睡
troop	队伍
spare	不用的
sewer	污水管
parse	作语法分析
morph	变形
cacti	仙人掌
tacky	俗气的
spool	线轴
demon	魔鬼
moody	喜怒无常
annex	附件
begin	开始
fuzzy	模糊的
patch	色斑
water	水
lumpy	笨重的
admin	管理
omega	欧米茄
limit	限度
tabby	斑猫
macho	男子气概
aisle	过道
skiff	小船
basis	原因
plank	木板
verge	边缘
botch	笨蛋
crawl	爬行
lousy	糟糕的
slain	杀死
cubic	立方体的
raise	提升
wrack	沉船
guide	指导
foist	把……强加
cameo	精彩片段
under	在下面
actor	男演员
revue	时事讽刺歌舞剧
fraud	欺诈
harpy	哈比
scoop	勺
climb	攀登
refer	参考
olden	古老的
clerk	店员
debar	德巴尔
tally	计数
ethic	伦理
cairn	凯恩
tulle	薄纱
ghoul	食尸鬼
hilly	多小山的
crude	原油
apart	分开地
scale	规模
older	更老的
plain	平原
sperm	精子
briny	多盐分的
abbot	方丈
rerun	重播
quest	探索
crisp	脆的
bound	跳跃
befit	适合
drawn	绘制
suite	一套
itchy	发痒的
cheer	欢呼
bagel	百吉饼
guess	猜测
broad	宽阔的
axiom	公理
chard	查德
caput	卡普特
leant	倾斜的
harsh	严厉的
curse	诅咒
proud	自豪的
swing	摆动
opine	认为
taste	味道
lupus	狼疮
gumbo	秋葵
miner	矿工
green	绿色
chasm	裂缝
lipid	脂质
topic	话题
armor	盔甲
brush	刷子
crane	起重机
mural	壁画
abled	能干的
habit	习惯
bossy	专横的
maker	制造商
dusky	昏暗的
dizzy	头晕的
lithe	柔韧性好的
brook	溪
jazzy	爵士乐的
fifty	五十
sense	感觉
giant	巨人
surly	脾气坏的
legal	合法的
fatal	致命的
flunk	不及格
began	开始
prune	修剪
small	小的
slant	倾斜
scoff	嘲笑
torus	环面
ninny	傻子
covey	科维
viper	毒蛇
taken	拿
moral	道德的
vogue	时尚
owing	未付的
token	代币
entry	进入
booth	售货棚
voter	选民
chide	责骂
elfin	精灵
ebony	乌木制的
neigh	嘶叫
minim	极小值
melon	甜瓜
kneed	跪下
decoy	动物
voila	给你。
ankle	踝关节
arrow	箭
mushy	糊状的
tribe	部落
cease	停止
eager	渴望的
birth	出生
graph	图表
odder	古怪的
terra	泰拉
weird	奇怪的
tried	尝试
clack	咔哒声
color	颜色
rough	粗糙的
weigh	权衡
uncut	未切割
ladle	长柄勺
strip	带
craft	手艺
minus	减
dicey	危险的
titan	泰坦
lucid	清醒的
vicar	牧师
dress	连衣裙
ditch	沟
gypsy	吉普赛人
pasta	意大利面食
taffy	太妃糖
flame	火焰
swoop	俯冲
aloof	冷漠的
sight	景象
broke	打破了
teary	泪流满面
chart	图表
sixty	六十
wordy	罗嗦的
sheer	纯粹的
leper	麻风病人
nosey	多管闲事的
bulge	隆起
savor	品味
clamp	夹紧
funky	时髦的
foamy	泡沫的
toxic	有毒的
brand	品牌
plumb	钻研
dingy	又黑又脏的
butte	巴特
drill	训练
tripe	牛肚
bicep	二头肌
tenor	男高音
krill	磷虾
worse	更糟的
drama	戏
hyena	鬣狗
think	认为
ratio	比率
cobra	眼镜蛇
basil	罗勒
scrum	并列争球
bused	公共汽车
phone	电话
court	法院
camel	骆驼
proof	证据
heard	听到
angel	天使
petal	花瓣
pouty	手铐
throb	悸动
maybe	大概
fetal	胎儿的
sprig	小枝
spine	脊柱
shout	呼喊
cadet	学员
macro	宏
dodgy	狡猾的
satyr	好色之徒
rarer	罕见的
binge	狂欢
trend	趋势
nutty	疯子
leapt	跳跃
amiss	错
split	分裂
myrrh	没药
width	宽度
sonar	声纳
tower	塔
baron	男爵
fever	发烧
waver	减弱
spark	火花
belie	掩饰
sloop	单桅帆船
expel	驱逐
smote	打击
baler	打捆机
above	在上面
north	北
wafer	薄饼
scant	不足的
frill	褶边
awash	淹没
snack	点心
scowl	怒视
frail	脆弱的
drift	漂流
limbo	地狱边境
fence	栅栏
motel	汽车旅馆
ounce	盎司
wreak	造成
revel	狂欢
talon	鹰爪
prior	先前的
knelt	跪下
cello	大提琴
flake	小薄片
debug	调试
anode	阳极
crime	罪行
salve	药膏
scout	童子军
imbue	使充满
pinky	小指
stave	梯级
vague	模糊的
chock	塞住
fight	打仗
video	视频
stone	石
teach	教
cleft	裂口
frost	严寒天气
prawn	对虾
booty	战利品
twist	扭曲
apnea	呼吸暂停
stiff	不易弯曲的
plaza	广场
ledge	岩架
tweak	扭
board	板
grant	授予
medic	医生
bacon	培根
cable	缆绳
brawl	争吵
slunk	偷偷摸摸
raspy	沙哑刺耳的
forum	论坛
drone	嗡嗡声
women	女人
mucus	粘液
boast	自夸
toddy	托迪
coven	科文
tumor	肿瘤
truer	真实的
wrath	愤怒
stall	货摊
steam	水蒸气
axial	轴向的
purer	纯净的
daily	每日的
trail	追踪
niche	市场定位
mealy	米利
juice	果汁
nylon	尼龙
plump	丰满的
merry	愉快的
flail	连枷
papal	教皇的
wheat	小麦
berry	浆果
cower	畏缩
erect	垂直的
brute	残酷的人
leggy	长腿的
snipe	鹬
sinew	筋
skier	滑雪者
penny	便士
jumpy	提心吊胆的
rally	集会
umbra	本影
scary	恐怖的
modem	调制解调器
gross	总的
avian	鸟类的
greed	贪婪
satin	缎子
tonic	补品
parka	派克大衣
sniff	闻
livid	铁青
stark	明显的
trump	王牌
giddy	头晕
reuse	重新使用
taboo	禁忌
avoid	避免
quote	引用
devil	魔王
liken	把…比作
gloss	光泽
gayer	盖尔
beret	贝雷帽
noise	噪音
gland	腺
dealt	处理
sling	吊索
rumor	谣言
opera	歌剧
thigh	大腿
tonga	汤加
flare	闪耀
wound	伤口
white	白色
bulky	庞大的
etude	练习曲
horse	马
circa	大约
paddy	帕迪
inbox	收件箱
fizzy	起泡的
grain	粮食
exert	发挥
surge	激增
gleam	发微光
belle	贝儿
salvo	齐射
crush	压坏
fruit	水果
sappy	多愁善感的
taker	接受者
tract	大片土地
ovine	绵羊
spiky	尖头的
frank	直率的
reedy	里德
filth	污物
spasm	痉挛
heave	隆起
mambo	曼波
right	正当
clank	叮当声
trust	相信
lumen	流明
borne	负荷
spook	幽灵
sauce	调味汁
amber	琥珀色
lathe	车床
carat	克拉
corer	取芯器
dirty	肮脏的
slyly	狡猾地
affix	附上
alloy	合金
taint	污点
sheep	羊
kinky	古怪的
wooly	毛茸茸的
mauve	淡紫色
flung	挥动
yacht	帆船
fried	油炸
quail	鹌鹑
brunt	冲击
grimy	肮脏的
curvy	弯曲的
cagey	小心谨慎
rinse	冲洗
deuce	见鬼
state	状态
grasp	抓住
milky	奶制的
bison	野牛
graft	嫁接
sandy	多沙的
baste	在…上涂抹油脂
flask	瓶子
hedge	树篱
girly	少女
swash	挥霍
boney	骨瘦如柴
coupe	轿跑车
endow	天生赋予
abhor	憎恶
welch	韦尔奇
blade	刀身
tight	牢固的
geese	鹅
miser	吝啬鬼
mirth	欢乐
cloud	云
cabal	阴谋集团
leech	水蛭
close	关
tenth	第十
pecan	美洲山核桃
droit	所有权
grail	圣杯
clone	克隆
guise	表现形式
ralph	拉尔夫
tango	探戈
biddy	毕蒂
smith	史密斯
mower	割草机
payee	受款人
serif	衬线
drape	悬垂
fifth	第五
spank	用手打
glaze	釉
allot	分配
truck	卡车
kayak	皮艇
virus	病毒
testy	易怒的
tepee	圆锥形帐篷
fully	充分地
zonal	地带性
metro	地铁
curry	咖喱
grand	壮丽的
banjo	班卓琴
axion	轴子
bezel	挡板
occur	发生
chain	链条
nasal	鼻腔
gooey	粘的
filer	文件管理器
brace	支架
allay	减轻
pubic	阴部的
raven	掠夺
plead	申辩
gnash	啃
flaky	薄的
munch	用力咀嚼
dully	无聊地
eking	勉强
thing	事情
slink	溜走
hurry	匆忙
theft	盗窃
shorn	剪短
pygmy	侏儒
ranch	大牧场
wring	拧
lemon	柠檬
shore	岸
mamma	妈妈
froze	冻结
newer	更新的
style	风格
moose	驼鹿
antic	滑稽的
drown	淹死
vegan	素食主义者
chess	国际象棋
guppy	孔雀鱼
union	协会
lever	操纵杆
lorry	卡车
image	形象
cabby	出租车司机
druid	德鲁伊
exact	准确的
truth	真相
dopey	昏昏欲睡的
spear	矛
cried	哭
chime	钟声
crony	亲信
stunk	臭味
timid	胆小的
batch	一批
gauge	测量
rotor	转子
crack	裂纹
curve	曲线
latte	拿铁
witch	女巫
bunch	串
repel	击退
anvil	铁砧
soapy	苏比
meter	米
broth	肉汤
madly	疯狂地
dried	干燥的
scene	场景
known	已知的
magma	岩浆
roost	栖息
woman	成年女子
thong	丁字裤
punch	用拳猛击
pasty	糊状的
downy	柔和的
knead	揉捏
whirl	旋转
rapid	迅速的
clang	叮当声
anger	愤怒
drive	驾驶
goofy	傻瓜
email	电子邮件
music	音乐
stuff	东西
bleep	哔哔声
rider	骑手
mecca	麦加
folio	对开本
setup	设置
verso	维索
quash	撤销
fauna	动物群
gummy	软糖
happy	快乐的
newly	最近
fussy	挑剔的
relic	遗物
guava	番石榴
ratty	鼠
fudge	软糖
femur	股骨
chirp	啁啾声
forte	特长
alibi	托辞
whine	哭哭啼啼
petty	次要的
golly	天哪
plait	编结
fleck	斑点
felon	重罪犯
gourd	葫芦
brown	棕色的
ficus	榕树
stash	藏匿
decry	谴责
wiser	更聪明的
junta	军政府
visor	面罩
daunt	使胆怯
scree	碎石
impel	促使
await	等候
press	按
whose	谁的
turbo	涡轮
stoop	俯身
speak	谈
mangy	肮脏的
eying	注视
inlet	小湾
crone	老太婆
pulse	脉搏
mossy	苔藓
staid	古板的
hence	因此
pinch	拧
teddy	泰迪
sully	败坏
snore	打鼾
ripen	成熟
snowy	下雪的
attic	阁楼
going	离去
leach	过滤
mouth	嘴
hound	猎犬
clump	丛
tonal	音调的
bigot	偏执狂
peril	危险
piece	块
blame	责备
haute	上流社会
spied	窥探
undid	解开
intro	简介
basal	基本的
shine	闪耀
gecko	壁虎
rodeo	牛仔竞技比赛
guard	警卫
steer	驾驶
loamy	壤土
scamp	流氓
scram	快滚
manly	强壮的
hello	你好
vaunt	吹嘘
organ	器官
feral	野性的
knock	敲
extra	额外的
condo	公寓
adapt	适应
willy	威利
polka	波尔卡舞
rayon	人造丝
skirt	短裙
faith	信仰
torso	人体躯干
match	火柴
mercy	怜悯
tepid	温热的
sleek	光滑的
riser	立管
peace	和平
flush	脸红
catty	猫
login	登录
eject	弹出
roger	罗杰
rival	竞争对手
untie	解开
refit	改装
aorta	主动脉
adult	成人
judge	法官
rower	划手
artsy	艺术的
rural	乡村的
shave	刮胡子
aahed	哎呀
aalii	（aaii）
aargh	啊
aarti	地图
abaca	阿巴卡
abaci	阿巴奇
abaft	船尾
abaka	阿巴卡
abamp	阿巴普
aband	之前
abash	使惭愧
abask	阿巴斯克
abaya	忽视
abbas	阿巴斯
abbed	阿巴德
abbes	修道院院长
abeam	是
abear	打开
abele	分享
abers	阿伯斯
abets	教唆
abies	冷杉
abler	能干的
ables	表格
ablet	能干的
ablow	阿布罗
abohm	哦，哦
aboil	中止
aboma	阿博玛
aboon	艾博恩
abord	首先
abore	中止
abram	打开
abray	艾布拉
abrim	阿布里姆
abrin	四月
abris	阿布里斯
absey	Absee
absit	腹股沟炎
abuna	阿布纳
abune	阿布内
abuts	邻接
abuzz	喧哗的
abyes	阿贝斯
abysm	使
acais	阿卡伊斯
acari	蜱螨
accas	阿克斯
acerb	尖刻的
acers	阿瑟
aceta	醋酸盐
achar	地区
ached	疼痛
aches	疼痛
achoo	阿乔
acids	酸
acidy	酸
acini	腺泡
ackee	阿克
acker	阿克
acmes	顶点
acned	阿克内德
acnes	痤疮
acock	阿克
acold	冰
acred	尖刻的
acres	英亩
acros	阿克罗斯
acted	行动
actin	肌动蛋白
acton	阿克顿
acyls	酰基
adaws	阿达斯
adays	艾迪斯
addax	阿达克斯
added	补充
adder	加法器
addio	再会
addle	麻木
adeem	阿德姆
adhan	阿丹
adieu	再见
adios	再见。
adits	坑道
adman	广告人
admen	广告人
admix	混合
adobo	阿多博
adown	阿东
adoze	剂量
adrad	阿德拉德
adred	地址
aduki	阿杜基
adunc	我补充说
adust	（阿杜）
advew	adview
adyta	阿德塔
adzed	阿德兹
adzes	阿兹
aecia	艾西亚
aedes	伊蚊
aegis	庇护
aeons	移涌
aerie	艾利
aesir	埃塞尔
afald	阿费尔德
afara	外部
afars	外部
afear	失音的
aflaj	阿法拉
afore	之前
afrit	复制
afros	非洲裔
agama	阿加玛
agami	阿加米
agars	阿加尔
agast	阿加斯特
agave	龙舌兰
agaze	玛瑙
agene	议程
agers	阿格斯
agger	阿格
aggie	阿吉
aggri	阿格里
aggro	愤怒
aggry	怨恨
aghas	啊
agila	敏捷的
agios	阿吉奥斯
agism	敏捷
agist	焦虑
agita	添加
aglee	灼热的
aglet	肩带
agley	艾格利
agloo	警觉的
aglus	发光体
agmas	阿格玛斯
agoge	教堂
agone	阿贡
agons	痛苦
agood	现在
agria	阿格里亚
agrin	阿格林
agros	农业
agued	严重的
agues	水
aguna	论据
aguti	阿古蒂
aheap	啊
ahent	没有人
ahigh	啊
ahind	后面
ahing	阿欣
ahint	阿欣特
ahold	阿霍尔德
ahull	啊哈
ahuru	布局
aidas	帮助
aided	帮助
aides	助手
aidoi	真正的
aidos	艾多斯
aiery	艾尔斯
aigas	艾加
aight	摘录
ailed	生病的
aimed	针对
aimer	爱
ainee	物质
ainga	只有
aioli	艾尔
aired	播出
airer	空气器
airns	艺术
airth	注意
airts	高度
aitch	艾奇
aitus	羊
aiver	艾弗
aiyee	昨天
aizle	你好
ajies	阿杰斯
ajiva	阿吉瓦
ajuga	脑
ajwan	六月
akees	阿克斯
akela	阿克拉
akene	亚辛
aking	我的
akita	秋田
akkas	女性的
alaap	阿拉普
alack	形状
alamo	阿拉莫
aland	阿兰
alane	艾伦
alang	阿兰
alans	平衡
alant	阿拉特
alapa	基础
alaps	阿拉普斯
alary	阿拉里
alate	阿拉特
alays	阿拉斯
albas	专辑
albee	阿尔比
alcid	阿尔西德
alcos	阿尔科斯
aldea	村庄
alder	桤木
aldol	奥尔多
aleck	艾力克
alecs	亚历克斯
aleft	警觉的
aleph	阿莱夫
alews	亚历克斯
aleye	阿莱耶
alfas	阿尔法
algal	藻类
algas	藻类
algid	藻类
algin	阿尔金
algor	阿尔戈
algum	一些
alias	别名
alifs	Alifs公司
aline	艾琳
alist	主义者
aliya	阿莉亚
alkie	阿尔基
alkos	碱性的
alkyd	醇酸
alkyl	烷基
allee	阿莉
allel	阿莱尔
allis	艾利斯
allod	阿洛德
allyl	烯丙基
almah	阿尔玛
almas	灵魂
almeh	阿尔梅
almes	施舍
almud	施舍
almug	阿尔穆格
alods	孤岛
aloed	警觉的
aloes	芦荟
aloha	你好
aloin	芦荟素
aloos	你好
alowe	芦荟
altho	高度
altos	阿尔托斯
alula	阿鲁拉
alums	校友
alure	明矾
alvar	阿尔瓦
alway	总是
amahs	未知的
amain	阿曼
amate	爱
amaut	终点
amban	安班
ambit	范围
ambos	二者都
ambry	橱柜
ameba	阿米巴
ameer	阿默尔
amene	阿门
amens	阿门
ament	大小
amias	阿米亚斯
amice	伙计
amici	朋友
amide	酰胺
amido	阿米多
amids	阿米兹
amies	朋友
amiga	朋友
amigo	朋友
amine	胺
amino	氨基
amins	胺
amirs	埃米尔
amlas	阿米拉
amman	名称
ammon	阿蒙
ammos	弹药
amnia	安尼亚
amnic	阿姆尼克
amnio	羊膜
amoks	阿莫克斯
amole	阿莫尔
amort	阿莫特
amour	恋情
amove	移动
amowt	阿莫特
amped	削弱
ampul	安瓿
amrit	阿姆利特
amuck	疯狂
amyls	戊基
anana	菠萝
anata	安纳塔
ancho	宽度
ancle	锚
ancon	锚
andro	安德罗
anear	戒指
anele	阿内尔
anent	其他的
angas	安格斯
anglo	盎格鲁
anigh	安尼
anile	年
anils	阿尼尔
anima	灵魂
animi	动画
anion	负离子
anise	八角
anker	锚
ankhs	安克斯
ankus	安克斯
anlas	_其他组织者
annal	年鉴
annas	安娜
annat	其他
anoas	阿诺亚斯
anole	阿诺尔
anomy	异名
ansae	设置
antae	安泰
antar	假设
antas	水平
anted	赌注
antes	赌注
antis	里斯
antra	安特拉
antre	第二
antsy	坐立不安的
anura	阿努拉
anyon	年份（s）
apace	迅速地
apage	删除
apaid	快速
apayd	阿佩特
apays	底部
apeak	猿类
apeek	公众的
apers	报纸
apert	打开
apery	阿佩里
apgar	阿普加
aphis	蚜虫
apian	火
apiol	阿皮奥
apish	阿皮什
apism	狂犬病
apods	等
aport	摄入
appal	骇人听闻的
appay	可怕的
appel	上诉
appro	批准
appui	支持
appuy	按
apres	围裙
apses	后堂
apsis	穹窿
apsos	阿普索斯
apted	适应
apter	阿普特
aquae	水彩画
aquas	阿奎斯
araba	阿拉巴
araks	阿拉克人
arame	电线
arars	阿拉斯
arbas	arb
arced	弧形
archi	拱门
arcos	拱门
arcus	弧
ardeb	阿黛布
ardri	阿德里
aread	地区
areae	地区
areal	区域的
arear	地区
areas	地区
areca	槟榔
aredd	阿雷德
arede	阿雷德
arefy	Arefy
areic	地区
arene	阿伦
arepa	阿雷帕
arere	地区
arete	阿雷特
arets	阿雷特
arett	单位格式
argal	阿加尔
argan	阿尔甘
argil	泥
argle	争论
argol	阿尔戈
argon	氩
argot	隐语
argus	论据
arhat	罗汉
arias	阿里亚斯
ariel	艾瑞尔
ariki	阿里基
arils	假种皮
ariot	阿里奥
arish	阿里什
arked	床单
arled	偶像
arles	阿尔勒
armed	武装
armer	贫穷的
armet	臂膀
armil	阿米尔
arnas	里斯
arnut	阿恩斯
aroba	阿罗巴
aroha	阿罗哈
aroid	阿罗伊德
arpas	阿尔帕斯
arpen	arp
arrah	阿拉
arras	阵列
arret	疤痕
arris	阿里斯
arroz	米
arsed	纵火
arses	屁股
arsey	阿西
arsis	屁股
artal	阿尔特尔
artel	阿尔特尔
artic	文章
artis	艺术家
aruhe	蕨根
arums	阿鲁姆斯
arval	事件
arvee	阿维
arvos	价值
aryls	芳基
asana	体位法
ascon	阿斯康
ascus	阿斯库斯
asdic	ASDIC
ashed	灰烬
ashes	灰烬
ashet	灰烬
asked	问
asker	询问者
askoi	屏风
askos	灰烬
aspen	山杨
asper	阿斯珀
aspic	肉冻
aspie	阿斯匹亚
aspis	阿斯皮斯
aspro	阿斯波罗
assai	阿西
assam	阿萨姆
asses	屁股
assez	够了
assot	阿索
aster	紫菀
astir	阿斯蒂尔
astun	阿斯顿
asura	阿修罗
asway	斜道
aswim	游泳
asyla	阿西拉
ataps	阿塔普斯
ataxy	阿塔西
atigi	阿蒂吉
atilt	（阿迪）
atimy	阿蒂玛
atlas	地图集
atman	自动取款机
atmas	阿特马斯
atmos	大气
atocs	原子能
atoke	阿托克
atoks	环礁
atoms	原子
atomy	原子的
atony	无力
atopy	特应性
atria	中庭
atrip	阿特里普
attap	阿塔普
attar	附件
atuas	实际情况
audad	奥达
auger	螺旋钻
aught	什么都没有
aulas	教训
aulic	奥里奇
auloi	大厅
aulos	班级
aumil	奥米尔
aunes	盎司
aunts	阿姨们
aurae	金
aural	听觉的
aurar	有
auras	光环
aurei	奥里斯
aures	金
auric	金
auris	奥里斯
aurum	金
autos	汽车
auxin	生长素
avale	吞咽
avant	前卫的
avast	开放
avels	艾夫斯
avens	阿文思
avers	厌恶
avgas	中止
avine	艾文
avion	飞机
avise	警告
aviso	警告
avize	贪婪
avows	声明
avyze	阿维泽
awarn	觉醒
awato	和户
aways	远离
awdls	作者
aweel	今天
aweto	阿维托
awing	惊醒
awmry	（awmry）
awned	遮篷
awner	雨篷
awols	擅离职守
awork	做工
axels	阿克塞尔
axile	轴心
axils	轴心
axing	砍掉
axite	轴
axled	轴
axles	车轴
axman	阿克斯曼
axmen	斧头
axoid	轴突
axone	轴突
axons	轴突
ayahs	阿亚
ayaya	阿雅
ayelp	艾尔普
aygre	艾格里
ayins	斧头
ayont	阿约特
ayres	艾尔斯
ayrie	分享
azans	阿扎内
azide	叠氮化物
azido	叠氮化物
azine	阿津
azlon	阿兹隆
azoic	偶氮的
azole	唑
azons	氮酮
azote	硝酸盐
azoth	阿佐
azuki	阿祖基
azurn	阿祖恩
azury	蔚蓝的
azygy	警觉的
azyme	阿齐米
baaed	咩咩叫
baals	巴尔
babas	巴巴斯
babel	巴贝尔
babes	宝贝们
babka	巴布卡
baboo	巴布
babul	巴布尔
babus	巴布斯
bacca	浆果
bacco	培根
baccy	巴西
bacha	小心
bachs	巴赫斯
backs	背
baddy	坏蛋
baels	贝尔
baffs	巴夫
baffy	巴菲
bafts	巴夫茨
baghs	巴格斯
bagie	贝吉
bahts	泰铢
bahus	巴胡斯
bahut	巴胡特
bails	保释
bairn	拜恩
baisa	贝萨
baith	字节
baits	诱饵
baiza	拜扎
baize	拜泽
bajan	下来
bajra	快跑！
bajri	奔跑
bajus	巴朱斯
baked	烤
baken	回来
bakes	烘焙
bakra	铜
balas	子弹
balds	秃顶
baldy	秃顶的
baled	打包
bales	捆
balks	阻碍
balky	犹豫不决的
balls	球
bally	巴利
balms	香膏
baloo	巴鲁
balsa	巴尔萨
balti	波罗的海
balun	旋转
balus	球
bambi	斑比
banak	香焦
banco	银行
bancs	班克斯
banda	班达
bandh	班德
bands	乐队
bandy	班迪
baned	路径
banes	贝恩斯
bangs	刘海
bania	光
banks	银行
banns	禁令
bants	班茨
bantu	班图
banty	平庸的
banya	班雅
bapus	巴布斯
barbe	胡须
barbs	倒钩
barby	芭比
barca	船
barde	大的
bardo	吟游诗人
bards	吟游诗人
bardy	巴迪
bared	赤裸
barer	巴勒
bares	赤裸
barfi	颜色
barfs	呕吐
baric	巴里克
barks	吠叫
barky	驳船
barms	乳房
barmy	酒鬼
barns	孩子们
barny	公羊
barps	呕吐
barra	酒吧
barre	巴尔
barro	黏土
barry	巴里
barye	地点
basan	巴桑
based	基于
basen	基础
baser	卑鄙的
bases	基地
basho	巴沙
basij	盆
basks	晒太阳
bason	玻璃
basse	低音
bassi	巴西
basso	巴索
bassy	贝西
basta	足够地
basti	巴斯蒂
basto	百思图
basts	巴斯茨
bated	减弱
bates	贝茨
baths	洗澡
batik	蜡染
batta	不
batts	巴茨
battu	被打败了
bauds	波特
bauks	鲍克斯
baulk	语言
baurs	鲍尔斯
bavin	巴文
bawds	缓冲区
bawks	叫声
bawls	大喊大叫
bawns	奖金
bawty	淫秽的
bayed	咆哮
bayer	拜耳
bayes	贝斯
bayle	字节
bayts	字节
bazar	巴扎
bazoo	巴祖
beads	珠
beaks	喙
beaky	尖嘴的
beals	比尔斯
beams	光束
beamy	比米
beano	豆
beans	豆
beany	比尼
beare	熊
bears	熊
beath	比思
beats	跳动
beaty	跳动
beaus	博斯
beaut	美女
beaux	情人
bebop	贝博普
becke	贝克
becks	贝克
bedad	贝达德
bedel	分享
bedes	拜托
bedew	贝多
bedim	贝迪姆
bedye	评级
beedi	甜菜
beefs	比夫斯
beeps	哔哔声
beers	啤酒
beery	啤酒
beets	甜菜
begad	二者都
begar	贝加尔
begem	贝格姆
begot	生
begum	贝格姆
beige	米色
beigy	贝基
beins	骨
bekah	冻僵的
belah	分裂
belar	熊
belay	保雷
belee	贝莉
belga	比利时的
bells	钟声
belon	贝隆
belts	皮带
bemad	发疯
bemas	贝马斯
bemix	贝米克斯
bemud	贝蒙
bends	弯曲
bendy	弯曲的
benes	腿
benet	腿
benga	%s（%s字节）
benis	写
benne	里面
benni	在里面
benny	本尼
bento	便当
bents	便当
benty	本蒂
bepat	坚决的
beray	浆果
beres	贝雷斯
bergs	山
berko	伯克
berks	文件夹
berme	红色
berms	护堤
berob	贝罗布
beryl	绿柱石
besat	占用
besaw	铁
besee	佰色
beses	时代
besit	着魔的
besom	贝索姆
besot	贝索特
besti	最好的
bests	最好的
betas	贝塔斯
beted	贝塔
betes	贝蒂斯
beths	贝思。
betid	贝蒂德
beton	混凝土
betta	贝塔
betty	贝蒂
bever	贝弗
bevor	之前
bevue	可执行文件
bevvy	贝维
bewet	可编辑
bewig	移动
bezes	贝兹
bezil	边框
bezzy	没有
bhais	有效的
bhaji	巴吉
bhang	邦
bhats	巴茨
bhels	底部
bhoot	脚
bhuna	基础
bhuts	必和必拓
biach	b
biali	比亚里
bialy	双性恋
bibbs	比布斯
bibes	比比斯
biccy	比西
bices	比克斯
bided	等待
bider	咬
bides	拜斯
bidet	坐浴盆
bidis	最后一次见到
bidon	罐子
bield	领域
biers	棺材
biffo	牛肉
biffs	比夫斯
biffy	比菲
bifid	双歧
bigae	比盖
biggs	比格斯
bigha	比加
bight	比赫特
bigly	极大地
bigos	偏执狂
bijou	比约
biked	骑自行车
biker	摩托车手
bikes	自行车
bikie	比基尼
bilbo	比尔博
bilby	比尔比
biled	胆汁
biles	英里
bilgy	汽车
bilks	诈骗
bills	账单
bimah	诵经台
bimas	比姆
bimbo	宾博
binal	二元的
bindi	很大
binds	束缚
biner	宾纳
bines	宾斯
bings	狂欢
bingy	暴饮暴食
binit	位
binks	宾克斯
bints	宾茨
biogs	传记
biont	生物
biota	生物群
biped	两足动物
bipod	双脚架
birds	鸟
birks	伯克斯
birle	统一
birls	贝尔斯
biros	比罗斯
birrs	比尔
birse	箭头
birsy	桦树
bises	野牛
bisks	比斯克
bisom	比索姆
bitch	贱人
biter	位
bites	咬
bitos	位
bitou	位
bitsy	卑鄙的
bitte	拜托
bitts	比特
bivia	比维亚
bivvy	露营车
bizes	奇怪的
bizzo	奇怪的
bizzy	古怪的
blabs	废话
blads	叶子
blady	布莱迪
blaer	床单
blaes	白色
blaff	废话
blags	布拉格
blahs	废话
blain	痘痘
blams	责备
blart	布拉特
blase	布拉斯
blash	亵渎
blate	岩石
blats	插槽
blatt	床单
blaud	蓝色
blawn	布朗
blaws	蓝色
blays	布莱斯
blear	惨淡的
blebs	气泡
blech	金属板
blees	花
blent	布莱特
blert	流血
blest	祝福
blets	布莱茨
bleys	布莱斯
blimy	天哪
bling	闪亮的
blini	买了
blins	布林斯
bliny	布林斯
blips	光点
blist	水泡
blite	布莱特
blits	布利茨
blive	停留
blobs	斑点
blocs	阻碍
blogs	博客
blook	网志书
bloop	布洛普
blore	年
blots	污渍
blows	吹
blowy	脸红
blude	布鲁德
bluds	布鲁兹
bludy	妄想
blued	发蓝
blues	忧郁
bluet	布鲁特
bluey	花
bluid	布鲁伊德
blume	花
blunk	布伦克
blurs	模糊
blype	彭佩
boabs	公猪
boaks	箱
boars	野猪
boart	板
boats	船
bobac	波巴赫
bobak	博巴克
bobas	博巴斯
bobol	波波
bobos	波波人
bocca	口
bocce	博切
bocci	博奇
boche	波切
bocks	博克斯
boded	预兆
bodes	预兆
bodge	博奇
bodhi	菩提
bodle	棍枝
boeps	波普
boets	盒
boeuf	博伊夫
boffo	波夫
boffs	全部的
bogan	软的
bogey	博吉
boggy	博吉
bogie	转向架
bogle	裸体的
bogue	错误
bogus	假的
bohea	坏的
bohos	博霍斯
boils	沸腾
boing	博因
boink	博因克
boite	盒子
boked	博克
bokeh	书
bokes	博克斯
bokos	灌木丛
bolar	博拉尔
bolas	博拉斯
bolds	球
boles	球
bolix	博利克斯
bolls	棉铃
bolos	博洛斯
bolts	螺栓
bolus	丸
bomas	炸弹
bombe	炸弹
bombo	炸弹
bombs	炸弹
bonce	邦斯
bonds	纽带
boned	骨瘦如柴
boner	博纳
bones	骨头
bongs	邦斯
bonie	邦尼斯
bonks	邦克斯
bonne	好
bonny	邦妮
bonza	美丽的
bonze	邦兹
booai	布艾
booay	布埃
boobs	乳房
boody	酒鬼
booed	嘘声
boofy	酒鬼
boogy	酒鬼
boohs	嘘
books	书
booky	书呆子
bools	布尔
booms	繁荣
boomy	繁荣
boong	是 啊。
boons	恩惠
boord	板
boors	乡下佬
boose	嘘声
boots	靴子
boppy	波比
borak	博拉克
boral	硼砂
boras	训练
borde	应该
bords	边缘
bored	无聊的
boree	博雷
borel	博雷尔
borer	蛀虫
bores	无聊的
borgo	博尔戈
boric	鲍里斯
borks	博克斯
borms	博姆斯
borna	博尔纳
boron	硼
borts	远离的
borty	波蒂
bortz	六
bosie	赤脚的
bosks	老板
bosky	博斯基
boson	玻色子
bosun	水手长
botas	靴子
botel	博泰尔
botes	靴子
bothy	二者都
botte	桶
botts	博茨
botty	博蒂
bouge	移动
bouks	布克斯
boult	博尔特
bouns	布恩斯
bourd	波德
bourg	村镇
bourn	伯恩
bouse	布塞
bousy	布西
bouts	搏斗
bovid	牛的
bowat	字节
bowed	鞠躬
bower	鲍尔
bowes	鲍斯。
bowet	鲍特
bowie	鲍伊
bowls	碗
bowne	鲍恩
bowrs	弓箭手
bowse	鲍斯
boxed	盒装的
boxen	盒
boxes	盒
boxla	拨号
boxty	方形的
boyar	纱线
boyau	内胆
boyed	博伊德
boyfs	男孩
boygs	博伊格斯
boyla	男朋友
boyos	男孩
boysy	男孩的
bozos	笨蛋
braai	布雷
brach	打破了
brack	布雷克
bract	苞片
brads	布拉兹
braes	咆哮
brags	吹嘘
brail	咆哮
braks	刹车
braky	丢失的
brame	吹牛
brane	破碎的
brank	布兰克
brans	布兰斯
brant	布兰特
brast	布拉斯特
brats	小鬼
brava	好极了
bravi	布拉维
braws	吹嘘
braxy	布拉西
brays	嘶叫
braza	臂
braze	硬钎焊
bream	布雷姆
brede	宽的
breds	宽度
breem	错误
breer	兄弟
brees	短的
breid	布雷德
breis	额外的
breme	负担
brens	燃烧
brent	布伦特
brere	更广的
brers	布雷尔斯
breve	短的
brews	酿造
breys	布雷斯
brier	荆棘
bries	布里
brigs	布里格斯
briki	砖
briks	砖
brill	布里尔
brims	边缘
brins	盐水
brios	布里奥斯
brise	微风
briss	刷
brith	英国
brits	英国人
britt	英国人
brize	布里兹
broch	过程
brock	布洛克
brods	肉汤
brogh	布罗
brogs	布罗兹
brome	溴
bromo	布罗莫
bronc	布朗克
brond	布朗德
brool	布罗尔
broos	兄弟们
brose	博泽
brosy	过程
brows	眉头
brugh	布鲁
bruin	棕色的
bruit	传播
brule	燃烧
brume	雾
brung	布伦
brusk	刷
brust	乳房
bruts	未经加工的
buats	制造的
buaze	布阿兹
bubal	布尔
bubas	小家伙
bubba	布巴
bubbe	布贝
bubby	泡泡
bubus	布布斯
buchu	布楚
bucko	巴克
bucks	雄鹿
bucku	巴克
budas	警觉的
budis	用布莱叶盲文和之前的聊天室留言
budos	布多斯
buffa	有趣的
buffe	棕黄色
buffi	布菲
buffo	布福
buffs	爱好者
buffy	巴菲
bufos	胡扯
bufty	丰满的
buhls	布尔
buiks	肚子
buist	外面的
bukes	巴克斯
bulbs	灯泡
bulgy	鼓胀的
bulks	大块
bulla	布拉
bulls	公牛
bulse	球茎
bumbo	低音鼓
bumfs	流浪汉
bumph	颠簸
bumps	颠簸
bumpy	坎坷的
bunas	基础
bunce	来源
bunco	邦科
bunde	外滩
bundh	外滩
bunds	外滩
bundt	捆
bundu	夹克
bundy	邦迪
bungs	桶
bungy	邦吉
bunia	布尼亚
bunje	先进的
bunjy	邦吉
bunko	邦科
bunks	铺位
bunns	底部
bunts	短发
bunty	邦蒂
bunya	晴朗的
buoys	浮标
buppy	胖乎乎的
buran	逃跑
buras	布拉斯
burbs	打嗝
burds	伯兹
buret	滴定管
burfi	伯菲
burgh	伯格
burgs	伯格斯
burin	布林
burka	布卡
burke	伯克
burks	伯克斯
burls	伯尔斯
burns	烧伤
buroo	布鲁
burps	打嗝
burqa	布卡
burro	黄油
burrs	毛刺
burry	伯里
bursa	法氏囊
burse	伯斯
busby	巴斯比
buses	公共汽车
busks	街头表演
busky	忙碌的
bussu	布苏
busti	_其他组织者
busts	半身像
busty	丰满的
buteo	布托
butes	但是
butle	瓶
butoh	钮扣
butts	屁股
butty	巴蒂
butut	按钮
butyl	丁基
buzzy	嗡嗡的
bwana	布瓦纳
bwazi	布瓦齐
byded	拜德
bydes	投标
byked	比克
bykes	拜克斯
byres	拜尔斯
byrls	伯尔斯
byssi	旁路
bytes	字节
byway	顺便说一句
cabas	电缆
caber	卡伯
cabob	驾驶室
cabre	山羊
cacas	卡卡
cacks	卡克斯
cacky	仙人掌
cadee	落下
cades	串
cadge	乞讨
cadgy	凯蒂
cadie	凯蒂
cadis	今天
cadre	干部
caeca	卡埃卡
caese	卡塞语
cafes	咖啡馆
caffs	咖啡馆
caged	笼
cager	凯杰
cages	笼子
cagot	卡戈
cahow	卡霍
caids	凯兹
cains	卡恩斯
caird	卡片
cajon	卡戎
cajun	卡琼
caked	结块
cakes	蛋糕
cakey	卡基
calfs	小牛
calid	卡利德
calif	加州
calix	杯
calks	卡尔克斯
calla	马蹄莲
calls	电话
calms	平静下来
calmy	平静的
calos	卡洛斯
calpa	加州大学
calps	卡尔普斯
calve	小牛
calyx	花萼
caman	卡曼
camas	床
cames	脚
camis	卡米斯
camos	迷彩服
campi	领域
campo	坎波
camps	营地
campy	坎皮
camus	加缪
caned	鞭打
caneh	卡内
caner	手杖
canes	手杖
cangs	苍
canid	犬科动物
canna	美人蕉
canns	戛纳
canso	疲劳
canst	坎斯特
canto	篇
cants	坎茨
canty	康蒂
capas	盖子
caped	披风
capes	层
capex	资本支出
caphs	卡普斯
capiz	卡皮兹
caple	卡普尔
capon	卡彭
capos	卡波斯
capot	卡波特
capri	卡普里
capul	头部
carap	卡拉普
carbo	卡波
carbs	碳水化合物
carby	卡比
cardi	卡
cards	卡
cardy	卡
cared	关心
carer	护工
cares	关心
caret	插入符号
carex	苔草
carks	汽车
carle	卡尔
carls	%%s的s
carns	卡恩斯
carny	卡尼
carob	角豆
carom	卡罗姆
caron	卡隆
carpi	卡皮
carps	鲤鱼
carrs	汽车
carse	卡塞
carta	卡塔
carte	菜单
carts	手推车
carvy	沙皇
casas	房屋
casco	头盔
cased	外壳
cases	案例
casks	木桶
casky	卡斯基
casts	铸造
casus	箱
cates	美食
cauda	考达
cauks	超出范围
cauld	考尔德
cauls	管
caums	下车
caups	奶牛
cauri	过程
causa	原因
cavas	卡瓦斯
caved	屈服
cavel	卡维尔
caver	洞穴探险者
caves	洞穴
cavie	卡维
cawed	哄骗
cawks	呱呱叫
caxon	卡克森
ceaze	齐泽
cebid	塞比德
cecal	盲肠
cecum	盲肠
ceded	放弃
ceder	塞德
cedes	割让
cedis	塞迪斯
ceiba	木棉
ceili	塞利
ceils	细胞
celeb	名人
cella	塞拉
celli	细胞
cells	细胞
celom	细胞
celts	凯尔特人
cense	许可证
cento	一百
cents	美分
centu	中央
ceorl	英寸
cepes	塞普斯
cerci	圈子
cered	塞雷德
ceres	谷神星
cerge	塞奇
ceria	西莉亚
ceric	铈
cerne	核心
ceroc	零的
ceros	零
certs	对
certy	当然
cesse	停止
cesta	路
cesti	塞斯蒂
cetes	塞特斯
cetyl	十六烷基
cezve	管
chace	每一个
chack	查克
chaco	查科
chado	查多
chads	查兹
chaft	这个
chais	查伊斯
chals	查尔斯
chams	查姆斯
chana	查纳
chang	青稞酒
chank	成克
chape	查佩
chaps	皮套裤
chapt	小伙子
chara	查拉
chare	查理
chark	查克
charr	查尔
chars	查斯
chary	谨慎的
chats	聊天
chave	钥匙
chavs	查维斯
chawk	查克
chaws	查斯
chaya	查亚
chays	蔡斯
cheep	奇普
chefs	厨师
cheka	检查
chela	大提琴
chelp	切普
chemo	化疗
chems	化学
chere	切尔
chert	燧石
cheth	切思
chevy	雪佛兰
chews	咀嚼
chewy	难嚼的
chiao	焦立中
chias	基亚斯
chibs	孩子们
chica	女孩
chich	时髦的
chico	奇科
chics	时髦的
chiel	基尔
chiks	奇克斯
chile	智利
chimb	奇姆
chimo	奇摩
chimp	黑猩猩
chine	Chine
ching	青
chink	裂口
chino	奇诺
chins	下巴
chips	炸薯条
chirk	奇克
chirl	奇尔
chirm	框架
chiro	奇罗
chirr	奇尔
chirt	奇特
chiru	圆圈
chits	奇茨
chive	韭菜
chivy	奇维
chizz	奇兹
choco	震惊
chocs	冲击
chode	Chode
choil	唱诗班
choko	乔科
choky	窒息的
chola	乔拉
choli	切利
cholo	乔洛
chomp	咀嚼
chons	Chons公司
choof	乔夫
choon	六月
chops	砍
chota	乔塔
chott	乔特
chout	乔特
choux	卷心菜
chowk	乔克
chows	食物
chubs	笨蛋
chufa	丘法
chuff	笨蛋
chugs	查格斯
chums	密友
churl	粗野的人
churr	丘尔
chuse	选择
chuts	溜槽
chyle	科尔
chyme	食糜
chynd	去
cibol	赛博
cided	苹果酒
cides	苹果酒
ciels	天空
ciggy	雪茄烟
cilia	纤毛
cills	cils
cimar	顶部
cines	电影
cinqs	辛克斯
cions	歌曲
cippi	古罗马
circs	马戏团
cires	蜡
cirls	卷云
cirri	西里
cisco	思科
cissy	西西
cists	系统
cital	城堡
cited	引用
citer	西特尔
cites	引用
cives	雪茄
civet	果子狸
civie	西维
civvy	平民
clach	岩石
clade	分支
clads	枝
claes	钥匙
clags	克拉格
clame	蛤蜊
clams	蛤蜊
clans	家族
claps	鼓掌
clapt	克拉普特
claro	清楚的
clart	清楚的
clary	克莱里
clast	碎屑
clats	克拉
claut	克劳特
clave	钥匙
clavi	钥匙
claws	爪
clays	粘土
cleck	克莱克
cleek	克莱克
cleep	克莱普
clefs	谱号
clegs	聪明的
cleik	克莱克
clems	克莱姆斯
clepe	克莱普
clept	悄悄地
cleve	克莱夫
clews	线索
clied	克莱德
clies	咔哒声
clift	克利夫特
clime	气候
cline	克莱恩
clint	克林特
clipe	削减
clips	剪辑
clipt	陈词滥调
clits	阴蒂
cloam	克隆
clods	土块
cloff	克洛夫
clogs	木屐
cloke	时钟
clomb	克隆
clomp	跺脚
clonk	克朗克
clons	复制同时包含克隆和原始克隆（可能是成组）的选择时，请重新链接复制的克隆
cloop	哗啦
cloot	克洛特
clops	克洛普斯
clote	克隆
clots	血块
clour	克洛尔
clous	克劳斯
clows	克洛斯
cloye	克洛伊
cloys	克洛伊斯
cloze	完形填空
clubs	俱乐部
clues	线索
cluey	线索
clunk	咯咯声
cnida	新的
coact	合作
coady	科迪
coala	床单
coals	煤
coaly	煤
coapt	烤
coarb	考伯
coate	科特
coati	科蒂
coats	外套
cobbs	科布斯
cobby	科比
cobia	科比亚
coble	科布尔
cobza	抄袭
cocas	可可豆
cocci	球菌
cocco	椰子
cocks	公鸡
cocky	自大的
cocos	可可
codas	尾声
codec	编解码器
coded	编码的
coden	代码
coder	编码员
codes	代码
codex	法典
codon	密码子
coeds	女生
coffs	咖啡
cogie	操
cogon	科贡
cogue	科格
cohab	科哈布
cohen	科恩
cohoe	科霍
cohog	棕色的
cohos	科霍斯
coifs	头巾
coign	点火
coils	线圈
coins	硬币
coirs	椰子
coits	科茨
coked	焦化
cokes	可乐
colas	尾巴
colby	科尔比
colds	感冒
coled	科尔德
coles	具有
coley	科利
colic	绞痛
colin	科林
colls	科尔斯
colly	科利
colog	颜色
colts	小马
colza	科扎
comae	使残废
comal	科马尔
comas	逗号
combe	梳子
combi	康比
combo	联合体
combs	梳子
comby	康比
comer	到场者
comes	来
commo	常见的
comms	通信
commy	康米
compo	镇静
comps	公司
compt	康普特
comte	数
comus	科姆斯
coned	科内德
cones	椎体
coney	科尼
confs	交谈
conga	康加
conge	康奇
congo	刚果
conia	科尼亚
conin	科宁
conks	康克斯
conky	康基
conne	笨蛋
conns	康涅狄格州
conte	账目
conto	解释
conus	柯纳斯
convo	康沃
cooch	库奇
cooed	咕咕
cooee	库伊
cooer	库尔
cooey	库伊
coofs	库夫斯
cooks	厨师
cooky	库克
cools	冷却
cooly	冷静的
coomb	库姆
cooms	库姆斯
coomy	酷
coons	库恩斯
coops	鸡舍
coopt	笼子
coost	库斯特
coots	库茨
cooze	煮
copal	杯子
copay	科帕伊
coped	应付
copen	科本
coper	科珀
copes	杯子
coppy	副本
copra	椰子酱
copsy	警察
coqui	科奎
coram	科拉姆
corbe	科比
corby	科尔比
cords	绳索
cored	核心
cores	核心
corey	科里
corgi	科基
coria	科里亚
corks	软木塞
corky	软木的
corms	球茎
corni	科尼
corno	科诺
corns	玉米
cornu	科努
corps	军团
corse	比赛
corso	课程
cosec	科赛克
cosed	宠爱
coses	东西
coset	陪集
cosey	舒适的
cosie	科西
costa	科斯塔
coste	成本
costs	成本
cotan	科坦
coted	婴儿床
cotes	婴儿床
coths	科茨
cotta	科塔
cotts	科茨
coude	弯头，弯头
coups	政变
courb	库布
courd	Courd公司
coure	将~a移到红心皇后身上。
cours	课程
couta	库塔
couth	成本
coved	觊觎
coves	海湾
covin	科文
cowal	考尔
cowan	考恩
cowed	畏缩
cowks	牛仔
cowls	风帽
cowps	牛仔
cowry	考里
coxae	臀部
coxal	Coxal
coxed	哄
coxes	可乐
coxib	抑制剂
coyau	科约
coyed	羞怯的
coyer	害羞的
coypu	科普
cozed	舒适的
cozen	欺骗
cozes	可口可乐
cozey	你好！
cozie	烹调
craal	昨天
crabs	蟹
crags	峭壁
craic	克雷克
craig	克雷格
crake	裂纹
crame	奶油
crams	填鸭
crans	克兰斯
crape	废话
craps	废话
crapy	糟糕的
crare	克雷
craws	峭壁
crays	克雷斯
creds	信任状
creel	筒子架
crees	你相信吗？
crems	面霜
crena	奶油
creps	裂缝
crepy	创造
crewe	创建
crews	船员
crias	小狗
cribs	婴儿床
cries	哭
crims	罪行
crine	哭
crios	克里奥斯
cripe	地窖
crips	哎呀
crise	危机
crith	克里特
crits	关键的
croci	十字架
crocs	尖牙
croft	克罗夫特
crogs	克罗格斯
cromb	克朗
crome	铬
cronk	克朗克
crons	老太婆
crool	克罗尔
croon	低吟
crops	作物
crore	克罗尔
crost	地壳
crout	克劳特
crows	乌鸦
croze	克罗兹
cruck	克鲁克
crudo	粗制的
cruds	积垢
crudy	克鲁迪
crues	洪水
cruet	拐杖
cruft	粗糙的
crunk	克鲁克
cruor	凝血
crura	克鲁拉
cruse	地壳
crusy	结壳
cruve	克鲁夫
cryer	哭闹者
ctene	女儿
cubby	小房间
cubeb	库布
cubed	立方
cuber	立方体
cubes	立方体
cubit	立方英尺
cuddy	卡迪
cuffo	袖口
cuffs	袖口
cuifs	CUIFS公司
cuing	线索
cuish	库什
cuits	熟的
cukes	糖
culch	卡尔奇
culet	库莱特
culex	库蚊
culls	挑选
cully	卡利
culms	秆
culpa	过失
culti	邪教
cults	邪教
culty	邪教
cumec	库梅克
cundy	狡猾的
cunei	楔形文字
cunit	库尼特
cunts	贱人
cupel	碗橱
cupid	丘比特
cuppa	库帕
cuppy	丘比
curat	清洁的
curbs	限制
curch	克奇
curds	凝乳
curdy	可恶的
cured	治愈
curer	类型
cures	治愈
curet	刮匙
curfs	曲线
curia	库里亚
curie	居里夫人
curli	是咖喱。
curls	卷发
curns	凝乳
curny	暴躁的
currs	咖喱
cursi	进展
curst	诅咒
cusec	CUSEC
cushy	轻松的
cusks	尖头
cusps	尖端
cuspy	轻快的
cusso	新的
cusum	库苏姆
cutch	卡奇
cuter	更可爱的
cutes	削减
cutey	可爱的
cutin	角质
cutis	皮肤
cutto	卡托
cutty	卡蒂
cutup	切
cuvee	库维
cuzes	沙发
cyano	氰基
cyans	青色
cycad	苏铁
cycas	苏铁
cyder	网络
cylix	赛利克斯
cymae	之前
cymar	蓝色
cymas	聚伞花序
cymes	方案
cymol	西莫
cysts	囊肿
cytes	细胞
cyton	细胞素
czars	时间
daals	放下
dabba	达巴
daces	达克斯
dacha	达卡
dacks	笨蛋
dadah	药物
dadas	鉴于
dados	数据
daffs	愚蠢的
daffy	达菲
dagga	露水
daggy	匕首
dagos	是
dahls	达尔
daiko	大子。
daine	戴恩
daint	颜色
daker	达克尔
daled	戴上
dales	戴尔
dalis	达利斯
dalle	从
dalts	磨蹭
daman	达曼
damar	达马尔
dames	女士
damme	池塘
damns	达姆斯
damps	潮湿
dampy	潮湿的
dancy	跳舞
dangs	该死
danio	丹麦语
danks	谢谢
danny	丹尼
dants	但丁
daraf	时代
darbs	工作
darcy	达西
dared	敢于
darer	敢于
dares	敢于
darga	达尔加
dargs	黑暗的
daric	达里克
daris	黑暗的
darks	黑暗
darky	黑暗的
darns	该死的
darre	最后的
darts	飞镖
darzi	飞镖
dashi	大石
dashy	时髦的
datal	数据
dated	过时的
dater	_其他组织者
dates	日期
datos	数据
datto	日期
daube	道贝
daubs	涂抹
dauby	涂抹
dauds	涂抹
dault	涂抹
daurs	达斡尔族
dauts	抚摸
daven	达文斯
davit	吊柱
dawah	再见。
dawds	黎明
dawed	黎明
dawen	道恩
dawks	剂量
dawns	黎明
dawts	道茨
dayan	白天
daych	戴奇
daynt	丹特
dazed	茫然
dazer	眩晕
dazes	发呆
deads	死亡
deair	设计
deals	交易
deans	院长
deare	亲爱的
dearn	迪恩
dears	亲爱的
deary	亲爱的
deash	红色
deave	迪夫
deaws	死亡
deawy	迪威
debag	德巴
debby	黛比
debel	厚的
debes	你必须
debts	债务
debud	取芽
debur	去毛刺
debus	调试
debye	黛比
decad	脱咖啡因
decaf	脱咖啡因咖啡
decan	德肯
decko	甲板
decks	甲板
decos	装饰
dedal	德达尔
deeds	事迹
deedy	迪迪
deely	部分
deems	认为
deens	服务
deeps	深渊
deere	迪尔
deers	鹿
deets	迪茨
deeve	迪夫
deevs	服务
defat	脱脂
deffo	德福
defis	迪菲
defog	笛福
degas	德加
degum	德根
degus	住宅
deice	设备
deids	神明
deify	神化
deils	%1分升
deism	自然神论
deist	自然神论者
deked	脱咖啡因
dekes	甲板
dekko	德科
deled	删除
deles	其中之一
delfs	代尔斯
delft	代尔夫特
delis	熟食店
dells	戴尔
delly	德利
delos	德洛斯
delph	德尔夫
delts	钻研
deman	明天
demes	一角硬币
demic	德米克
demit	退出
demob	演示
demoi	德莫
demos	演示
dempt	免除
denar	钱
denay	否认
dench	丹奇
denes	丹斯
denet	德内
denis	丹尼斯
dents	凹痕
deoxy	脱氧核糖核酸
derat	预计起飞时间
deray	门
dered	德雷德
deres	他们的
derig	衍生
derma	真皮
derms	真皮
derns	德恩斯
derny	日记
deros	德罗斯
derro	贬损
derry	德里
derth	德思
dervs	德尔夫
desex	苔丝
deshi	德西
desis	德西斯
desks	办公桌
desse	放下
devas	剂量
devel	德维尔
devis	设计
devon	德文郡
devos	必须
devot	致力于
dewan	委员会
dewar	杜瓦瓶
dewax	脱蜡
dewed	露水
dexes	十
dexie	德克西
dhaba	真的？
dhaks	达克斯
dhals	达尔
dhikr	迪克尔
dhobi	多比
dhole	多尔
dholl	多尔
dhols	杜尔斯
dhoti	多蒂
dhows	邻居
dhuti	杜蒂
diact	迪亚克
dials	刻度盘
diane	黛安
diazo	重氮
dibbs	迪布斯
diced	切成丁
dicer	说
dices	骰子
dicht	关闭
dicks	迪克
dicky	迪克
dicot	双子叶
dicta	口述
dicts	格言
dicty	迪克蒂
diddy	迪迪
didie	迪迪
didos	迪多斯
didst	迪斯特
diebs	盗贼
diels	迪尔斯
diene	二烯烃
diets	饮食
diffs	差异
dight	迪格特
dikas	迪卡斯
diked	装饰
diker	戴克
dikes	堤坝
dikey	戴基
dildo	假阴茎
dilli	迪利
dills	莳萝
dimbo	丁博
dimer	二聚体
dimes	一角硬币
dimps	酒窝
dinar	第纳尔
dined	吃饭
dines	用餐
dinge	东西
dings	叮当声
dinic	迪尼奇
dinks	丁克斯
dinky	极小的
dinna	本地的
dinos	告诉我们
dints	牙齿
diols	二醇
diota	迪奥塔
dippy	笨蛋
dipso	下降
diram	迪拉姆
direr	说
dirke	比赛
dirks	德克斯
dirls	迪尔斯
dirts	污垢
disas	说
disci	光盘
discs	光盘
dishy	美味的
disks	磁盘
disme	十
dital	迪塔尔
ditas	迪塔斯
dited	编辑
dites	说吧。
ditsy	迪西
ditts	小调
ditzy	迪齐
divan	女主角
divas	女主角
dived	跳水
dives	跳水
divis	除数
divna	精彩的
divos	迪沃斯
divot	迪沃
divvy	迪维
diwan	塔穆兹的
dixie	迪克西
dixit	他说，
diyas	智利
dizen	昨天
djinn	吉恩
djins	男人
doabs	多布斯
doats	多茨
dobby	多比
dobes	双重的
dobie	每日的
dobla	弯曲
dobra	好的
dobro	好 啊
docht	医生
docks	码头
docos	多科斯
doddy	狡猾的
dodos	渡渡鸟
doeks	点
doers	实干家
doest	实干家
doeth	多斯
doffs	脱毛
dogan	多根
doges	狗狗
dogey	多吉
doggo	狗狗
doggy	狗狗
dogie	狗
dohyo	土表
doilt	多伊尔
doily	多利
doits	doits公司
dojos	道场
dolce	多尔西
dolci	糖果
doled	施舍
doles	救济金
dolia	美元
dolls	玩偶
dolma	多尔玛
dolor	痛苦的
dolos	多洛斯
dolts	笨蛋
domal	领域
domed	圆顶的
domes	圆顶
domic	多米克
donah	斯托拉
donas	数据
donee	受赠人
doner	多纳
donga	东啊
dongs	洞
donko	顿科
donna	唐娜
donne	多恩
donny	唐尼
donsy	唐西
doobs	末日
dooce	毒死
doody	杜迪
dooks	末日
doole	杜勒
dools	死亡
dooly	杜利
dooms	厄运
doomy	厄运
doona	找到
doorn	刺
doors	门
doozy	杜兹
dopas	之后
doped	掺杂
doper	兴奋剂
dopes	兴奋剂
dorad	线
dorba	是宿舍。
dorbs	多布斯
doree	多莉
dores	疼痛
doric	多里克
doris	多丽丝
dorks	笨蛋
dorky	笨蛋
dorms	宿舍
dormy	宿舍
dorps	村庄
dorrs	多尔斯
dorsa	多萨
dorse	多丝
dorts	蛋糕
dorty	蛋糕
dosai	文件夹
dosas	多萨斯
dosed	剂量
doseh	剂量
doser	剂量
doses	剂量
dosha	板
dotal	溺爱的
doted	宠爱
doter	点
dotes	宠爱
dotty	多蒂
douar	水
douce	柔软的
doucs	杜克斯
douks	多克斯
doula	杜拉
douma	斗马
doums	多姆斯
doups	豆荚
doura	金色的
douse	灌洗
douts	怀疑
doved	俯冲
doven	懒惰的
dover	多佛
doves	鸽子
dovie	再见
dowar	道瓦
dowds	道兹
dowed	嫁妆
dower	嫁妆
dowie	你会知道的
dowle	道尔
dowls	销钉
dowly	寒酸的
downa	向下
downs	唐斯
dowps	道普
dowse	道斯
dowts	道茨
doxed	打瞌睡
doxes	打瞌睡
doxie	多克西
doyen	老前辈
doyly	多伊尔斯
dozed	打瞌睡
dozer	推土机
dozes	打瞌睡
drabs	单调的
drack	喝
draco	德拉科
draff	拖沓
drags	拖拉
drail	拖拉
drams	德拉姆斯
drant	德兰特
draps	杀戮
drats	单调的
drave	拖拽
draws	绘制
drays	德雷斯
drear	正确的
dreck	污垢
dreed	三
dreer	通过
drees	德雷斯
dregs	渣滓
dreks	正确的
drent	德兰特
drere	德雷尔
drest	德雷斯特
dreys	德雷斯
dribs	点点滴滴
drice	德里斯
dries	干燥
drily	干的
drips	滴
dript	滴
droid	机器人
droil	滴水
droke	拖拽
drole	正确的
drome	娱乐场
drony	无人机
droob	勇气
droog	干的
drook	卓克
drops	滴
dropt	滴落
drouk	滴
drows	卓尔
drubs	德鲁布
drugs	药物
drums	鼓
drupe	核果
druse	葡萄
drusy	俄语
druxy	德鲁西
dryad	德赖德
dryas	Dryas
dsobo	DSOBO公司
dsomo	德索莫
duads	杜阿德
duals	双重的
duans	杜恩斯
duars	手
dubbo	笨蛋
ducal	公爵
ducat	杜卡特
duces	公爵
ducks	鸭子
ducky	小鸭
ducts	管道
duddy	达迪
duded	老兄
dudes	伙计们
duels	决斗
duets	二重唱
duett	二重唱
duffs	笨蛋
dufus	杜福斯
duits	英寸
dukas	杜卡斯
duked	达克
dukes	公爵
dukka	女儿
dulce	甜蜜的
dules	杜勒斯
dulia	杜利亚
dulls	迟钝的
dulse	评级
dumas	大仲马
dumbo	小飞象
dumbs	笨蛋
dumka	杜姆卡
dumky	倾倒
dumps	倾倒
dunam	杜南
dunch	晚午餐
dunes	沙丘
dungs	粪便
dungy	邓吉
dunks	扣篮
dunno	不知道
dunny	邓尼
dunsh	笨蛋。
dunts	扣篮
duomi	数据
duomo	大教堂
duped	欺骗
duper	骗子
dupes	欺骗
duple	双重
duply	屁股
duppy	笨蛋
dural	硬脑膜
duras	杜拉斯
dured	持续时间
dures	杜尔斯
durgy	杜吉
durns	白痴
duroc	杜洛克
duros	杜罗斯
duroy	杜洛瓦
durra	杜拉
durrs	杜尔斯
durry	疼痛
durst	德斯特
durum	硬粒
durzi	杜尔齐
dusks	黄昏
dusts	灰尘
duxes	杜克斯
dwaal	二重的
dwale	德维尔
dwalm	德瓦尔姆
dwams	德拉姆斯
dwang	胁迫
dwaum	德沃姆
dweeb	德韦布
dwile	德韦恩
dwine	二
dyads	二分体
dyers	染色工
dyked	Dyked
dykes	堤坝
dykey	戴基
dykon	迪肯
dynel	达尼尔
dynes	戴恩斯
dzhos	乔斯
eagre	老鹰
ealed	伊莱德
eales	埃莱斯
eaned	底部
eards	耳朵
eared	耳朵
earls	伯爵
earns	赚
earnt	恩特
earst	第一
eased	缓和
easer	画架
eases	缓和
easle	轻松的
easts	东边
eathe	错误
eaved	屋檐
eaves	屋檐
ebbed	退潮
ebbet	忙吗？
ebons	乌木
ebook	书
ecads	ECADS
eched	埃希德
eches	埃切斯
echos	回声
ecrus	埃克鲁斯
edema	水肿
edged	边缘的
edger	磨边机
edges	边缘
edile	白天
edits	编辑
educe	引出
educt	排出
eejit	ejitit
eensy	单身
eeven	简单的
eevns	简单的
effed	影响
egers	所有者
egest	埃格斯特
eggar	鸡蛋
egged	怂恿
egger	爱格
egmas	埃格马斯
ehing	爱玲
eider	羽绒
eidos	年
eigne	先生者
eiked	艾克
eikon	艾肯
eilds	秒
eisel	铁
ejido	伊吉多
ekkas	埃克斯
elain	伊莱恩
eland	伊兰
elans	埃兰
elchi	埃尔基
eldin	埃尔丁
elemi	埃莱米
elfed	精灵
eliad	列表
elint	埃琳特
elmen	埃尔门
eloge	私奔
elogy	伊洛吉
eloin	移走
elops	私奔
elpee	总是
elsin	埃尔辛
elute	洗脱
elvan	十一
elven	河流
elver	河流
elves	精灵
embar	安巴
embay	埃贝
embow	浮雕
embus	埃姆斯
emeer	记忆
emend	修正
emerg	埃默格
emery	金刚砂
emeus	峨眉
emics	流行病
emirs	埃米尔
emits	散发
emmas	艾玛斯
emmer	埃默尔
emmet	埃米特
emmew	埃默
emmys	艾美奖
emoji	表情符号
emong	埃蒙。
emote	表情
emove	情感
empts	清空
emule	埃穆勒
emure	鸸鹋
emyde	埃米德
emyds	埃米兹
enarm	使能
enate	使能
ended	结束了
ender	安德
endew	恩德
endue	恩杜
enews	新的
enfix	恩菲克斯
eniac	埃尼亚克
enlit	插入
enmew	名字
ennog	天
enoki	单位
enols	烯醇
enorm	诺姆
enows	伊诺斯。
enrol	登记
ensew	恩索
ensky	恩斯基
entia	恩提亚
enure	埃努尔
enurn	埃努恩
envoi	正在发送
enzym	酵素
eosin	曙红
epees	重剑
ephah	埃帕
ephas	伊法
ephod	以弗德
ephor	伊弗
epics	史诗
epopt	埃波特
epris	埃普里斯
eques	骑士
equid	马
erbia	埃尔比亚
erevs	埃列夫
ergon	埃尔根
ergos	因此
ergot	麦角
erhus	二胡
erica	艾丽卡
erick	埃里克
erics	埃里克斯
ering	戒指
erned	欧内斯
ernes	这个
erose	侵蚀
erred	犯错
erses	厄斯
eruct	埃鲁克特
erugo	埃鲁戈
erven	继承
ervil	埃尔维尔
escar	埃斯卡
escot	埃斯科特
esile	薄的
eskar	埃斯卡
esker	昨天
esnes	埃斯内斯
esses	这些
estoc	埃斯托克
estop	埃斯托普
estro	埃斯特罗
etage	地板
etape	步
etats	埃塔茨
etens	伊滕斯
ethal	伦理的
ethne	埃涅
ethyl	乙基
etics	伊提
etnas	埃特纳
ettin	埃廷
ettle	埃特尔
etuis	埃图伊斯
etwee	之间
etyma	词根
eughs	尤格斯
euked	尤金
eupad	尤帕德
euros	欧元
eusol	尤索尔
evens	晚上
evert	埃弗特
evets	伊夫茨
evhoe	埃夫霍
evils	邪恶
evite	避免
evohe	埃沃
ewers	水壶
ewest	埃维斯特
ewhow	哇
exams	考试
exeat	埃克塞特
execs	高管
exeem	埃克塞姆
exeme	埃克塞姆
exfil	埃克斯菲尔
exies	出口
exine	外壁
exing	退出
exits	出口
exode	出埃及记
exome	外显子组
exons	外显子
expat	外籍人士
expos	暴露
exude	流露
exuls	分泌
exurb	外星生物
eyass	下车
eyers	眼睛
eyots	字节
eyras	耳朵
eyres	东
eyrie	艾莉
eyrir	耳朵
ezine	4
fabby	法比
faced	面对
facer	做
faces	面孔
facia	仪表板
facta	事实
facts	事实
faddy	法迪
faded	已褪色的
fader	推子
fades	褪色
fadge	法奇
fados	法多斯
faena	费娜
faery	仙灵
faffs	假货
faffy	法菲
faggy	基佬
fagin	费金
fagot	法格特
faiks	法克斯
fails	失败
faine	费恩
fains	费恩斯
fairs	集市
faked	伪造的
faker	传真
fakes	赝品
fakey	法基
fakie	倒滑姿势
fakir	传真
falaj	输水道
falls	瀑布
famed	著名的
fames	饥荒
fanal	灯
fands	粉丝们
fanes	法恩斯
fanga	风扇
fango	泥
fangs	尖牙
fanks	芬克斯
fanon	风扇
fanos	粉丝
fanum	法纳姆
faqir	页面
farad	危险
farci	让我们
farcy	闹剧
fards	法兹
fared	进展顺利
farer	危害；
fares	车费
farle	制造它们
farls	放屁
farms	农场
faros	油漆
farro	聚会
farse	法斯
farts	放屁
fasci	光束
fasti	斋戒
fasts	禁食
fated	命中注定的
fates	命运
fatly	肥胖的
fatso	胖子
fatwa	法特瓦
faugh	福。
fauld	福尔德
fauns	牧神
faurd	法德
fauts	放下
fauve	福维
favas	豆
favel	贫民窟
faver	法弗
faves	爱好
fawns	小鹿
fawny	凉爽的
faxed	传真
faxes	传真
fayed	费耶德
fayer	费耶
fayne	文件
fayre	文件
fazed	费兹
fazes	费兹
feals	小便
feare	害怕
fears	恐惧
feart	字节
fease	费斯
feats	壮举
feaze	费兹
feces	粪便
fecht	冲突
fecit	制造的
fecks	费克斯
fedex	联邦快递
feebs	感觉
feeds	喂养
feels	感觉
feens	仙女
feers	远的
feese	阶段
feeze	费兹
fehme	什瓦特
feint	假装
feist	星期五
felch	费尔奇
felid	费利德
fells	倒下
felly	费利
felts	领域
felty	场
femal	女性的
femes	女性
femmy	女人
fends	抵挡
fendy	婊子
fenis	菲尼斯
fenks	芬克斯
fenny	芬尼
fents	芬茨
feods	食品
feoff	菲奥夫
ferer	费雷斯
feres	费雷斯
feria	费里亚
ferly	狂热地
fermi	费米
ferms	蕨类植物
ferns	蕨类植物
ferny	蕨类植物
fesse	臀部
festa	聚会
fests	固定的
festy	节日
fetas	胎儿
feted	盛宴
fetes	宴请
fetor	胎儿
fetta	片
fetts	费茨
fetwa	费塔
feuar	二月
feuds	世仇
feued	火
feyed	费耶德
feyer	费耶
feyly	费尔斯
fezes	粪便
fezzy	费兹
fiars	菲亚斯
fiats	菲亚特
fibro	纤维
fices	菲斯
fiche	插头
fichu	该死的。
ficin	菲恩
ficos	菲科斯
fides	菲德斯
fidge	菲奇
fidos	电邮
fiefs	封地
fient	恶魔
fiere	骄傲
fiers	骄傲
fiest	恶魔
fifed	大脚
fifer	菲弗
fifes	法夫
fifis	菲菲
figgy	无花果
figos	数字
fiked	失败
fikes	修复
filar	丝线
filch	窃取
filed	提出
files	文件夹
filii	孩子们
filks	菲尔克斯
fille	女孩
fillo	儿子
fills	填满
filmi	胶卷
films	电影
filos	菲洛斯
filum	丝
finca	庄园
finds	发现
fined	罚款
fines	罚款
finis	完成
finks	芬克斯
finny	芬尼
finos	结束
fiord	峡湾
fiqhs	菲克斯
fique	停留
fired	解雇
firer	四
fires	开火
firie	菲丽
firks	峡湾
firms	公司
firns	火
firry	菲里
firth	弗斯
fiscs	财政部
fisks	鱼
fists	拳头
fisty	拳头
fitch	惠誉
fitly	恰到好处
fitna	频率
fitte	菲特
fitts	猫咪
fiver	五
fives	五
fixed	固定的
fixes	修复
fixit	固定的
fjeld	费尔德
flabs	小瓶
flaff	炫耀
flags	旗帜
flaks	运气
flamm	火焰
flams	火焰
flamy	火焰
flane	法兰
flans	法兰
flaps	襟翼
flary	闪光的
flats	平地
flava	黄色的
flawn	缺陷
flaws	瑕疵
flawy	弗拉瓦
flaxy	亚麻的
flays	剥皮
fleam	跳蚤
fleas	跳蚤
fleek	弗雷克
fleer	弗雷尔
flees	逃离
flegs	箭头
fleme	跳蚤
fleur	芙蓉
flews	赘肉
flexi	弯曲
flexo	箭头
fleys	箭头
flics	电影
flied	飞
flies	苍蝇
flimp	飞人
flims	菲姆斯
flips	翻转
flirs	传单
flisk	好的
flite	飞
flits	飞片
flitt	弗利特
flobs	絮状物
flocs	絮状物
floes	浮冰
flogs	鞭子
flong	鞭子
flops	失败
flors	花
flory	弗洛里
flosh	鞭打
flota	舰队
flote	浮动
flows	流动
flubs	侥幸
flued	流体
flues	烟道
fluey	弗雷
fluky	侥幸的
flump	蓬松
fluor	氟
flurr	慌乱
fluty	长笛
fluyt	流体
flyby	飞过
flype	轻弹
flyte	飞行
foals	小马驹
foams	泡沫
foehn	出口
fogey	模糊的
fogie	雾
fogle	抓住
fogou	火
fohns	fontchooser
foids	鹅肝
foils	箔
foins	福因斯
folds	褶皱
foley	福利
folia	叶
folic	叶状的
folie	精神错乱
folks	乡亲们
folky	乡亲们
fomes	饥荒
fonda	方达
fonds	基金
fondu	背景
fones	丰内斯
fonly	可爱的
fonts	字体
foods	食品
foody	美食家
fools	傻瓜
foots	脚
footy	富足的
foram	是
forbs	福布
forby	禁令
fordo	福尔多
fords	福兹
forel	弗雷尔
fores	弗雷斯
forex	外汇
forks	叉子
forky	叉子
forms	形式
forts	强壮
forza	力量
forze	军队
fossa	福萨
fosse	壕
fouat	福亚特
fouds	福兹
fouer	福伊尔
fouet	鞭子
foule	人群
fouls	犯规
fount	喷泉
fours	四
fouth	错误
fovea	中心凹
fowls	家禽
fowth	福斯
foxed	狐狸
foxes	狐狸
foxie	狐狸
foyle	福伊尔
foyne	线
frabs	碎片
frack	压裂
fract	碎裂
frags	碎片
fraim	弗雷姆
franc	法郎
frape	打
fraps	弗拉普斯
frass	短语
frate	兄弟
frati	兄弟
frats	兄弟会
fraus	短语
frays	磨损
frees	释放
freet	自由的
freit	自由的
fremd	_前进
frena	刹车
freon	氟利昂
frere	兄弟
frets	烦恼
fribs	薯条
frier	炸薯条
fries	炸薯条
frigs	护卫舰
frise	天气很冷。
frist	弗里斯特
frith	弗里斯
frits	熔块
fritt	自由的
frize	天气很冷。
frizz	卷曲
froes	寒冷的
frogs	青蛙
frons	青蛙
frore	问
frorn	青蛙
frory	霜冻
frosh	嬉戏
frows	蛙类
frowy	弗劳
frugs	水果
frump	美丽的
frush	弗鲁什
frust	弗罗斯特
fryer	油炸锅
fubar	福巴尔
fubby	富比
fubsy	富比
fucks	操
fucus	福卡斯
fuddy	老古董
fudgy	软糖
fuels	燃料
fuero	富罗
fuffs	福夫斯
fuffy	富菲
fugal	赋格
fuggy	闷热的
fugie	逃跑
fugio	富吉奥
fugle	福格尔
fugly	鸟
fugus	福格斯
fujis	融合
fulls	满的
fumed	愤怒的
fumer	吸烟
fumes	烟雾
fumet	烟
fundi	芬迪
funds	基金
fundy	底部
fungo	芬戈
fungs	冯
funks	芬克斯
fural	糠醛
furan	呋喃
furca	福卡
furls	卷起
furol	糠醛
furrs	毛皮
furth	此外
furze	放屁
furzy	皮草
fused	融合
fusel	杂醇
fuses	熔丝
fusil	步枪
fusks	福克斯
fusty	守旧的
futon	蒲团
fuzed	引信
fuzee	引信
fuzes	引信
fuzil	引信
fyces	王牌
fyked	费克
fykes	费克斯
fyles	填满
fyrds	灯塔
fytte	费特
gabba	加巴
gabby	加比
gable	山墙
gaddi	加迪
gades	加德斯
gadge	年
gadid	女孩
gadis	女孩
gadje	复发页
gadjo	切换器
gadso	评级
gaffs	鱼叉
gaged	塞住
gager	加格
gages	量规
gaids	预期
gains	利润
gairs	话
gaita	口琴
gaits	步态
gaitt	盖特
gajos	伙计们
galah	加拉
galas	庆典
galax	加拉克斯
galea	加利亚
galed	擦伤
gales	大风
galls	胆汁
gally	勇敢的
galop	飞奔
galut	高卢
galvo	头
gamas	范围
gamay	加梅
gamba	腿
gambe	腿
gambo	甘博
gambs	甘布斯
gamed	游戏
games	游戏
gamey	勇敢的
gamin	孩子
gamme	范围
gammy	格米
ganch	全部的
gandy	甘迪
ganef	甘尼夫
ganev	加内夫
gangs	帮派
ganja	杂草
ganof	加诺夫
gants	手套
gaols	监狱
gaped	张开嘴
gaper	张嘴
gapes	目瞪口呆
gapos	缺口
gappy	加皮
garbe	加贝
garbo	嘉宝
garbs	装束
garda	加尔达
garis	线
garms	加姆斯。
garni	大的
garre	加勒
garth	加思
garum	鱼露
gases	气体
gasps	喘息
gaspy	加斯皮
gasts	客人
gatch	盖奇
gated	大门
gater	街道
gates	盖茨
gaths	盖斯
gator	鳄鱼
gauch	左撇子
gaucy	高西
gauds	高斯
gauje	很快
gault	高尔特
gaums	高姆斯
gaumy	俗艳的
gaups	高普
gaurs	白肢野牛
gauss	高斯
gauzy	薄纱的
gavot	加沃特
gawcy	说话者
gawds	高兹
gawks	目瞪口呆
gawps	目瞪口呆
gawsy	瓦斯
gayal	盖亚尔
gazal	气体
gazar	板材ary
gazed	凝视
gazes	凝视
gazon	凝视
gazoo	加索
geals	光
geans	手套
geare	齿轮
gears	齿轮
geats	赫茨
gebur	出生
gecks	格克斯
geeks	极客
geeps	极客
geest	介意
geist	精神
geits	盖茨
gelds	凝胶
gelee	吉利
gelid	凝胶
gelly	胶状的
gelts	盖尔斯
gemel	常见的
gemma	杰玛
gemmy	杰米
gemot	杰莫特
genal	一般的
genas	消息
genes	基因
genet	吉内特
genic	基因的
genii	天才
genip	精灵
genny	热尼
genoa	热那亚
genom	作者：
genro	根罗
gents	绅士
genty	男洗手间
genua	基纳
genus	属
geode	晶洞
geoid	大地水准面
gerah	移动
gerbe	滑轮
geres	基尔斯
gerle	盖尔
germs	细菌
germy	德语的
gerne	喜欢
gesse	格塞
gesso	石膏
geste	手势
gests	手势
getas	赫塔斯
getup	打扮
geums	格姆
geyan	齿轮
geyer	耶
ghast	可怕的
ghats	可能
ghaut	高特
ghazi	加齐
ghees	盖斯
ghest	根斯特
ghyll	盖尔
gibed	嘲笑
gibel	箭头
giber	对
gibes	嘲笑
gibli	吉布利
gibus	吉布斯
gifts	礼品
gigas	千兆
gighe	吉赫
gigot	吉戈特
gigue	吉格
gilas	疯子。
gilds	吉尔兹
gilet	背心
gills	鳃
gilly	吉利
gilpy	吉尔普斯
gilts	母猪
gimel	吉梅尔
gimme	给我
gimps	笨蛋
gimpy	懦弱的
ginch	金奇
ginge	我已经走了
gings	金格斯
ginks	金克斯
ginny	金妮
ginzo	金佐
gipon	吉蓬
gippo	吉波
gippy	吉比
girds	腰带
girls	女孩们
girns	吉恩斯
giron	吉隆
giros	吉罗斯
girrs	围儿
girts	围带
gismo	吉斯莫
gisms	吉斯姆
gists	酵母
gitch	吉奇
gites	吉特
giust	朱斯
gived	鉴于
gives	给予
gizmo	小发明
glace	冰
glads	幸福的
glady	格拉迪
glaik	格拉克
glair	格拉尔
glams	闪耀
glans	龟头
glary	耀眼的
glaum	玻璃
glaur	清楚的
glazy	耀眼的
gleba	格雷巴
glebe	土壤
gleby	土壤
glede	关于
gleds	高兴
gleed	高兴地
gleek	幸福的
glees	欢乐
gleet	格莱特
gleis	轨道
glens	峡谷
glent	格伦特
gleys	格雷斯
glial	胶质的
glias	玻璃
glibs	油嘴滑舌
gliff	格利夫
glift	格利夫特
glike	英语
glime	微光
glims	闪光
glisk	格利克
glits	格利茨
glitz	浮华
gloam	格洛姆
globi	罚款
globs	地球仪
globy	地球
glode	幸灾乐祸
glogg	格洛格
gloms	格洛姆斯
gloop	格鲁普
glops	格洛普斯
glost	格洛斯特
glout	幸灾乐祸
glows	发光
gloze	幸灾乐祸
glued	胶合
gluer	胶水工
glues	胶水
gluey	胶状的
glugs	胶水
glume	颖片
glums	忧郁
gluon	胶子
glute	臀大肌
gluts	过剩
gnarl	格纳尔
gnarr	啃咬
gnars	啃咬
gnats	蚊虫
gnawn	啃
gnaws	啃
gnows	侏儒
goads	刺激
goafs	采空区
goals	目标
goary	高丽
goats	山羊
goaty	山羊
goban	戈班
gobar	戈巴
gobbi	戈比
gobbo	驼背
gobby	戈比
gobis	蘑菇
gobos	有色片
godet	很好。
godso	老天爷
goels	好的
goers	观众
goest	客人
goeth	红色
goety	戈茨
gofer	戈弗
goffs	空间
gogga	戈加
gogos	戈戈斯
goier	戈耶
gojis	戈吉斯
golds	黄金
goldy	戈迪
goles	进球数
golfs	高尔夫
golpe	打击
golps	高尔夫球
gombo	高脚杯
gomer	戈默
gompa	粘贴
gonef	戈内夫
gongs	锣
gonia	追逐
gonif	戈尼夫
gonks	冈克斯
gonna	将要
gonof	戈诺夫
gonys	戈尼斯
gonzo	极不寻常的
gooby	古比
goods	商品
goofs	傻瓜
googs	傻瓜
gooks	外国佬
gooky	粘乎乎的
goold	金色的
gools	傻瓜
gooly	粘的
goons	暴徒
goony	傻瓜
goops	傻瓜
goopy	黏糊糊的
goors	傻瓜
goory	黏糊糊的
goosy	粘乎乎的
gopak	戈帕克
gopik	戈皮克
goral	戈拉尔
goras	脱粒机
gored	刺伤
gores	戈尔
goris	燃料
gorms	蓝色
gormy	戈姆斯
gorps	戈普斯
gorse	金雀花
gorsy	紧身胸衣
gosht	天哪
gosse	孩子
gotch	哥特
goths	哥特人
gothy	哥特
gotta	得以
gouch	古奇
gouks	古克斯
goura	蓝凤冠鸠
gouts	痛风
gouty	痛风
gowan	戈万
gowds	礼服
gowfs	戈夫斯
gowks	长袍
gowls	长袍
gowns	礼服
goxes	护目镜
goyim	戈伊姆
goyle	高尔
graal	格拉尔
grabs	抓住
grads	毕业生
graff	格拉夫
graip	圣杯
grama	克
grame	克
gramp	格拉普
grams	克
grana	格拉纳
grans	格兰斯
grapy	葡萄
gravs	坟墓
grays	灰色
grebe	格雷布
grebo	希腊人
grece	希腊人
greek	希腊人
grees	%1度
grege	希腊人
grego	希腊人
grein	文章
grens	限制
grese	格雷斯
greve	数
grews	格雷斯
greys	灰色的
grice	格里斯
gride	格里德
grids	网格
griff	格里夫
grift	诈骗
grigs	格里格斯
grike	希腊人
grins	格伦斯
griot	格里奥
grips	握紧
gript	握紧
gripy	握紧
grise	灰色
grist	格里斯特
grisy	格里西
grith	格里斯
grits	砂砾
grize	灰色的
groat	腹股沟
grody	城堡
grogs	烧粉
groks	希腊人
groma	格罗马
grone	绿色
groof	格罗夫
grosz	总的
grots	洞穴
grouf	【谚】rowu
grovy	小树林
grows	生长
grubs	幼虫
grued	厚的
grues	灰色
grufe	扒
grume	格鲁姆
grump	发脾气
grund	地面
gryce	格赖斯
gryde	锅
gryke	希腊人
grype	格雷型
guaco	瓜可
guana	瓜纳
guano	鸟粪
guans	鸟人
guars	瓜尔斯
gucks	废话
gucky	古奇
gudes	诸神
guffs	废话
gugas	古加斯
guids	伪装
guiro	圭罗
gulag	古拉格
gular	黄色的
gulas	八月
gules	红色
gulet	黄色的
gulfs	大口
gulfy	大口
gulls	海鸥
gulph	古尔夫
gulps	大口喝
gulpy	Gulpy公司
gumma	树胶瘤
gummi	橡胶
gumps	口香糖
gundy	冈迪
gunge	条件
gungy	粘乎乎的
gunks	怪人
gunky	粘乎乎的
gunny	麻布的
guqin	深度
gurdy	古迪
gurge	古尔奇
gurls	古尔斯
gurly	古里
gurns	古恩斯
gurry	古里
gursh	格什
gurus	大师
gushy	丰满的
gusla	古斯拉
gusle	光
gusli	轻的
gussy	格西
gusts	阵风
gutsy	勇敢的
gutta	古塔
gutty	家伙
guyed	盖伊
guyle	盖尔
guyot	盖约
guyse	眼睛
gwine	删除网络地址。gwine
gyals	脑回
gyans	犯罪嫌疑人
gybed	旋转
gybes	吉布斯
gyeld	吉尔德
gymps	健身房
gynae	雌蕊
gynie	吉妮
gynny	金妮
gynos	gnoys
gyoza	脑回
gyppo	吉波
gyppy	吉皮
gyral	脑回
gyred	红色
gyres	回旋
gyron	陀螺
gyros	陀螺
gyrus	脑回
gyved	旋转
gyves	回旋
haafs	哈夫斯
haars	她
hable	说话
habus	联系方式
hacek	乱劈
hacks	黑客
hadal	通话
haded	Haded
hades	星星
hadji	运送
hadst	哈斯特
haems	哈姆斯
haets	哈克茨
haffs	礁湖
hafiz	哈菲兹
hafts	斧头
haggs	哈格斯
hahas	哈哈
haick	哈克
haika	鲨鱼
haiks	海克斯
haiku	俳句
hails	欢呼
haily	海莉
hains	海恩斯
haint	海特
hairs	头发
haith	海斯
hajes	昨天
hajis	头发
hajji	头发
hakam	法官
hakas	哈卡斯
hakea	应用
hakes	哈克斯
hakim	哈基姆
hakus	搜索
halal	清真的
haled	硬朗的
haler	黑尔
hales	黑尔斯
halfa	哈尔法
halfs	一半
halid	左口鱼
hallo	你好
halls	大厅
halma	稻草
halms	稻草
halon	哈龙
halos	光环
halse	喉咙
halts	停顿
halva	一半
halwa	哈尔瓦
hamal	哈马尔
hamba	奴隶
hamed	哈米德
hames	哈姆斯
hammy	哈米
hamza	哈姆扎
hanap	哈纳普
hance	汉斯
hanch	汉奇
hands	手
hangi	设置RSDP、XSDT和RSDT.hangi的创建者版本
hangs	悬挂
hanks	汉克斯
hanky	手帕
hansa	汉莎
hanse	汉斯
hants	闹鬼
haole	豪乐
haoma	阅读
hapax	哈帕克斯
haply	顿悟
happi	氧气
hapus	删除
haram	被禁止的
hards	硬汉
hared	砍掉
hares	野兔
harim	天
harks	听着
harls	哈尔
harms	伤害
harns	哈恩斯
haros	哈罗斯
harps	竖琴
harts	哈特
hashy	哈西
hasks	哈克斯
hasps	搭扣
hasta	直到
hated	憎恨
hates	讨厌
hatha	哈塔
hauds	豪兹
haufs	堆
haugh	哈
hauld	拖
haulm	海姆
hauls	拖运
hault	拖运
hauns	豪斯
hause	豪斯
haver	伙计
haves	富人
hawed	支吾
hawks	鹰派
hawms	霍姆斯
hawse	锚链
hayed	海耶德
hayer	不
hayey	海伊
hayle	海勒
hazan	哈桑
hazed	模糊的
hazer	黑泽尔
hazes	雾霾
heads	头
heald	综
heals	治愈
heame	希姆
heaps	堆
heapy	堆
heare	赫尔
hears	听到
heast	东边
heats	加热
heben	举起
hebes	海布斯
hecht	赫克特
hecks	海克斯
heder	海德
hedgy	海吉
heeds	注意
heedy	希迪
heels	鞋跟
heeze	注意
hefte	周
hefts	分量
heids	海德斯
heigh	嗨
heils	总数
heirs	继承人
hejab	赫贾布
hejra	海吉拉
heled	完成
heles	海尔斯
helio	氦
hells	地狱
helms	赫尔姆斯
helos	你好
helot	海洛特
helps	帮助
helve	赫尔夫
hemal	赫马尔
hemes	血红素
hemic	偏瘫的
hemin	血红素
hemps	亨普斯
hempy	哼哼的
hench	健美的男士
hends	亨兹
henge	恒河
henna	指甲花
henny	亨尼
henry	亨利
hents	亨茨
hepar	肝
herbs	草本植物
herby	赫比
herds	畜群
heres	这里
herls	和赫尔斯
herma	赫尔玛
herms	隐士
herns	肾病和卒中
heros	英雄
herry	亨利
herse	赫塞
hertz	赫兹
herye	昨天
hesps	赫斯普
hests	海丝特
hetes	7
heths	赫斯
heuch	十六进制
heugh	哈
hevea	橡胶树
hewed	砍
hewer	昨天
hewgh	哼
hexad	六面体
hexed	勒克塞德
hexer	赫瑟
hexes	赫克斯
hexyl	己基
heyed	海耶德
hiant	歌曲
hicks	希克斯
hided	隐藏
hider	隐藏
hides	兽皮
hiems	希姆斯
highs	高点
hight	高度
hijab	头巾
hijra	绿色
hiked	徒步旅行
hiker	徒步旅行者
hikes	徒步旅行
hikoi	出汗
hilar	希拉
hilch	山丘
hillo	希洛
hills	山丘
hilts	剑柄
hilum	门
hilus	门
himbo	希博
hinau	希诺
hinds	母鹿
hings	欣
hinky	古怪的
hinny	欣妮
hints	提示
hiois	昨天
hiply	时髦的
hired	雇佣
hiree	承租人
hirer	租用人
hires	雇佣
hissy	嘶嘶声
hists	历史学者
hithe	发烧
hived	蜂巢
hiver	冬季
hives	荨麻疹
hizen	昨天
hoaed	高度
hoagy	灰白的
hoars	游戏
hoary	老掉牙的
hoast	马
hobos	流浪汉
hocks	飞节
hocus	霍克斯
hodad	标题
hodja	标题
hoers	妓女
hogan	霍根
hogen	高的
hoggs	霍格斯
hoghs	霍格斯
hohed	高度
hoick	嘿
hoied	等待
hoiks	我们一直在
hoing	等一下
hoise	举起
hokas	典当
hoked	霍克
hokes	霍克斯
hokey	霍基
hokis	今天
hokku	典当
hokum	胡说八道
holds	持有
holed	洞
holes	洞
holey	霍利
holks	女孩们
holla	你好
hollo	你好
holme	全部的
holms	福尔摩斯
holon	霍隆
holos	霍洛斯
holts	霍尔茨
homas	人类的
homed	回家
homes	家园
homey	家常的
homie	老乡
homme	男人
homos	人类
honan	河南
honda	本田
honds	狗
honed	磨练
honer	珩磨
hones	磨砺
hongi	商行
hongs	洪斯
honks	喇叭声
honky	白痴
hooch	呼
hoods	兜帽
hoody	帽衫
hooey	万岁
hoofs	蹄子
hooka	钩子
hooks	钩子
hooky	逃学
hooly	万岁
hoons	霍恩斯
hoops	篮圈
hoord	听到
hoors	号角
hoosh	呼
hoots	嘘声
hooty	胡闹
hoove	蹄子
hopak	跳
hoped	希望
hoper	霍珀
hopes	希望
hoppy	快乐
horah	霍拉
horal	小时
horas	小时
horis	霍利斯
horks	霍克斯
horme	霍姆
horns	角
horst	地垒
horsy	山
hosed	冲洗
hosel	霍塞尔
hosen	霍森
hoser	霍瑟
hoses	软管
hosey	霍西
hosta	咳嗽
hosts	主人
hotch	霍奇
hoten	霍廷
hotty	性感的
houff	小时数
houfs	猎犬
hough	霍夫
houri	胡里
hours	小时
houts	霍茨
hovea	牛肉
hoved	头
hoven	蹄子
hoves	霍夫斯
howbe	你好
howes	豪斯
howff	哈夫
howfs	你好
howks	豪克斯
howls	嚎叫
howre	你好
howso	怎么样
hoxed	胡闹
hoxes	今天
hoyas	霍亚斯
hoyed	霍耶德
hoyle	霍伊尔
hubby	老公
hucks	哈克斯
hudna	严峻的
hudud	胡都
huers	昨天
huffs	怒火
huffy	气喘吁吁的
huger	雨果
huggy	巨大的
huhus	预感
huias	惠亚斯
hulas	草裙舞
hules	胡尔斯
hulks	绿巨人
hulky	绿巨人
hullo	喂
hulls	外壳
hully	赫利
humas	人类
humfs	哼
humic	腐殖质的
humps	驼峰
humpy	驼背的
hunks	大块头
hunts	狩猎
hurds	赫兹
hurls	投掷
hurly	喧闹
hurra	万岁
hurst	赫斯特
hurts	伤害
hushy	安静的
husks	外壳
husos	胡索斯
hutia	胡蒂亚
huzza	胡扎
huzzy	哈奇
hwyls	乐趣
hydra	海德拉
hyens	海恩斯
hygge	海格
hying	海因
hykes	海克斯
hylas	海拉斯
hyleg	希腊人
hyles	嚎叫
hylic	海利克
hymns	赞美诗
hynde	_其他组织者
hyoid	舌骨
hyped	炒作
hypes	炒作
hypha	菌丝
hyphy	连字符。
hypos	海波斯
hyrax	海拉克斯
hyson	希森
hythe	海斯
iambi	亚姆比
iambs	短长
ibrik	混合的
icers	冰柜
iched	伊希德
iches	脑出血
ichor	伊科尔
icier	冰人
icker	讨厌的
ickle	易怒的
icons	图标
ictal	发作期
ictic	前南问题国际法庭
ictus	前庭
idant	伊丹特
ideas	思想
idees	艾迪斯
ident	识别号
idled	无所事事
idles	无所事事
idola	伊多拉
idols	偶像
idyls	田园诗
iftar	开斋节
igapo	伊加波
igged	伊格德
iglus	冰屋
ihram	伊赫拉姆
ikans	伊坎
ikats	伊卡茨
ikons	图标
ileac	伊莱克
ileal	回肠
ileum	回肠
ileus	肠梗阻
iliad	语言
ilial	髂骨的
ilium	髂骨
iller	雪貂
illth	倍数
imago	意象
imams	伊玛目
imari	伊玛里
imaum	伊玛姆
imbar	树
imbed	嵌入
imide	酰亚胺
imido	%1分钟
imine	亚胺
imino	分钟
immew	IMMEW
immit	伊米特
immix	伊米克斯
imped	妨碍
impis	自由的
impot	进口
impro	即兴表演
imshi	阴影
imshy	伊姆希
inapt	笨拙的
inarm	臂
inbye	英拜
incel	因塞尔
incle	包括
incog	收入
incus	砧骨
incut	砧木
indew	英德
india	印度
indie	独立音乐
indol	吲哚
indow	窗户
indri	_内容
indue	印度河
inerm	伊纳姆
infix	中缀
infos	新闻
infra	红外线
ingan	英根
ingle	英语
inion	伊尼翁
inked	墨水
inker	墨水瓶
inkle	印克尔
inned	Inned
innit	因尼特
inrun	英伦
inset	插图
inspo	英斯波
intel	情报
intil	英蒂尔
intis	单元
intra	内部
inula	菊粉
inure	使习惯于
inurn	因努恩
inust	因努斯特
invar	因瓦
inwit	英维特
iodic	碘的
iodid	碘伏
iodin	碘
ippon	伊彭
irade	愤怒的
irids	艾里斯
iring	Iring
irked	恼火的
iroko	伊罗科
irone	艾恩
irons	熨斗
isbas	低的
ishes	伊什
isled	孤岛
isles	小岛
isnae	伊斯奈
issei	伊塞
istle	明星
items	项目
ither	其他
ivied	我看
ivies	常春藤
ixias	智利
ixnay	没有人
ixora	时间
izard	伊扎德
izars	皮米
izzat	汗流浃背
jaaps	日本人
jabot	贾博特
jacal	贾卡尔
jacks	千斤顶
jacky	杰基
jaded	厌倦的
jades	玉器
jafas	同等的
jaffa	贾法
jagas	第一节
jager	亨特
jaggs	贾格斯
jaggy	锯齿状
jagir	贾格尔
jagra	年
jails	监狱
jaker	杰克
jakes	杰克
jakey	杰克
jalap	路径
jalop	贾洛普
jambe	腿
jambo	Jambo公司
jambs	侧壁
jambu	贾布
james	詹姆斯
jammy	果酱
jamon	火腿
janes	珍妮斯
janns	詹斯
janny	詹尼
janty	琥珀色
japan	日本
japed	日本佬
japer	贾珀
japes	日本佬
jarks	罐
jarls	贾尔斯
jarps	罐子
jarta	心
jarul	罐
jasey	家
jaspe	贾斯珀
jasps	日本网印资机材协会
jatos	杰托斯
jauks	美好的
jaups	黄疸
javas	爪哇
javel	好吧。
jawan	回答
jawed	下巴
jaxie	贾西亚
jeans	牛仔裤
jeats	杰茨
jebel	杰贝尔
jedis	绝地武士
jeels	水母
jeely	天哪
jeeps	吉普车
jeers	嘲笑
jeeze	天哪
jefes	老板
jeffs	杰夫斯
jehad	杰哈德
jehus	房子
jelab	杰拉布
jello	果冻
jells	果冻
jembe	珍贝
jemmy	杰米
jenny	珍妮
jeons	全斯
jerid	杰里德
jerks	混蛋
jerry	杰瑞
jesse	杰西
jests	开玩笑
jesus	上帝啊
jetes	喷气式飞机
jeton	杰顿
jeune	年轻人
jewed	犹太人
jewie	杰维
jhala	贾拉
jiaos	焦
jibba	吉巴
jibbs	bbs！
jibed	嘲笑
jiber	吉伯
jibes	嘲笑
jiffs	摇摆
jiggy	跳汰机
jigot	吉戈特
jihad	圣战
jills	吉尔
jilts	杰尔斯
jimmy	吉米
jimpy	吉米
jingo	金戈
jinks	怪胎
jinne	其他
jinni	金妮
jinns	金
jirds	吉尔兹
jirga	支尔格
jirre	rre
jisms	酒
jived	摇摆
jiver	吉弗
jives	摇摆
jivey	吉维
jnana	一月
jobed	工作
jobes	乔布斯
jocko	乔科
jocks	运动员
jocky	慢跑的
jocos	乔科斯
jodel	乔德尔
joeys	乔伊
johns	约翰
joins	加入
joked	开玩笑
jokes	笑话
jokey	开玩笑
jokol	尤科尔
joled	已折叠
joles	乔尔斯
jolls	颠簸
jolts	震动
jolty	乔蒂
jomon	乔蒙
jomos	名称
jones	琼斯
jongs	年轻的
jonty	琼蒂
jooks	运行
joram	乔丹
jorum	乔勒姆
jotas	霍塔舞
jotty	我没有
jotun	分钟
joual	焦耳
jougs	慢跑
jouks	乔克斯
joule	焦耳
jours	天
jowar	乔瓦尔
jowed	下巴
jowls	下巴
jowly	嚎叫
joyed	高兴
jubas	朱巴斯
jubes	朱布斯
jucos	尤科斯
judas	犹大
judgy	挑剔的
judos	柔道
jugal	朱加尔
jugum	朱古姆
jujus	朱珠
juked	突出
jukes	朱克斯
jukus	朱库斯
julep	七月
jumar	朱玛
jumby	庞比
jumps	跳跃
junks	垃圾
junky	垃圾
jupes	裙子
jupon	日本人
jural	法律上的
jurat	朱拉特
jurel	朱雷尔
jures	陪审团
justs	公正
jutes	黄麻
jutty	朱蒂
juves	尤文图斯
juvie	朱维
kaama	卡玛
kabab	卡巴布
kabar	新闻
kabob	歌舞伎
kacha	鸭子
kacks	大便
kadai	什么时候
kades	卡德斯
kadis	框架
kafir	卡菲尔
kagos	卡戈斯
kagus	卡格斯
kahal	卡哈尔
kaiak	凯克
kaids	凯兹
kaies	凯斯
kaifs	凯夫斯
kaika	凯卡
kaiks	凯克斯
kails	凯尔
kaims	凯姆斯
kaing	凯恩
kains	凯恩斯
kakas	卡卡斯
kakis	箱
kalam	卡尔姆
kales	羽衣甘蓝
kalif	卡利夫
kalis	卡利斯
kalpa	偏好
kamas	率
kames	卡姆斯
kamik	卡米克
kamis	卡米斯
kamme	梳子
kanae	渠道
kanas	卡纳斯
kandy	康迪
kaneh	卡内
kanes	凯恩斯
kanga	织物
kangs	康斯
kanji	汉字
kants	堡垒
kanzu	汉字
kaons	考恩斯
kapas	帽子
kaphs	卡普斯
kapok	木棉
kapow	卡波
kapus	守门员
kaput	卡普特
karas	战争
karat	克拉
karks	卡克斯
karns	卡恩
karoo	卡鲁
karos	卡洛斯
karri	卡里
karst	喀斯特
karsy	马车
karts	卡丁车
karzy	惩罚
kasha	卡沙
kasme	卡西姆
katal	加泰罗尼亚人
katas	卡塔斯
katis	凯蒂斯
katti	猫
kaugh	考夫
kauri	山羊
kauru	考鲁
kaury	考里
kaval	聪明的
kavas	计划
kawas	咖啡
kawau	卡沃
kawed	卡韦德
kayle	凯勒
kayos	卡约斯
kazis	案例
kazoo	卡祖
kebar	凯巴
kebob	凯博
kecks	凯克斯
kedge	基奇
kedgy	星期二
keech	看
keefs	基夫斯
keeks	基克斯
keels	龙骨
keema	化学
keeno	嫉妒
keens	基恩斯
keeps	保持
keets	基茨
keeve	基夫
kefir	凯菲尔
kehua	赞美
keirs	凯尔斯
kelep	一般的
kelim	克里姆
kells	凯尔斯
kelly	凯利
kelps	海带
kelpy	凯尔比
kelts	凯尔特
kelty	凯尔蒂
kembo	肯博
kembs	肯布斯
kemps	坎普斯
kempt	坎普特
kempy	肯比
kenaf	红麻
kench	放声大笑
kendo	剑道
kenos	基诺斯
kente	肯特
kents	肯特
kepis	凯皮斯
kerbs	路缘石
kerel	伙计
kerfs	切口
kerky	教堂
kerma	内核
kerne	核心
kerns	克恩斯。
keros	克洛斯
kerry	克里
kerve	克夫
kesar	凯萨尔
kests	壳
ketas	凯塔斯
ketch	凯奇
ketes	这
ketol	酮醇
kevel	基维尔
kevil	凯维尔
kexes	凯克斯
keyed	键控
keyer	钥匙
khadi	卡
khafs	卡夫
khans	可汗
khaph	哈夫
khats	卡其布
khaya	卡亚
khazi	卡齐
kheda	挑选
kheth	挑选
khets	赫茨
khoja	科哈
khors	霍尔斯
khoum	库姆
khuds	胡德斯
kiaat	交叉
kiack	凯克
kiang	江
kibbe	基比
kibbi	键位
kibei	基贝
kibes	冻疮
kibla	网状物
kicks	踢
kicky	好棒的
kiddo	孩子
kiddy	孩子
kidel	基德尔
kidge	基奇
kiefs	基夫
kiers	基尔斯
kieve	基夫
kievs	菜单
kight	基特
kikes	犹太人
kikoi	菊口
kiley	基利
kilim	公斤
kills	杀死
kilns	窑炉
kilos	公斤
kilps	盾
kilts	短裙
kilty	_压力单位：kilty
kimbo	金波
kinas	基诺
kinda	有点
kinds	种类
kindy	善良的
kines	肯斯
kings	国王
kinin	奎宁
kinks	扭结
kinos	电影院
kiore	基尔
kipes	基普斯
kippa	小帽
kipps	基普斯
kirby	柯比
kirks	柯克斯
kirns	克恩斯
kirri	错误
kisan	基桑
kissy	基西
kists	箱
kited	风筝
kiter	基特
kites	风筝
kithe	基特
kiths	风筝
kitul	配套元件
kivas	基辅
kiwis	猕猴桃
klang	音频
klaps	鼓掌
klett	地窖
klick	点击
klieg	清楚的
kliks	点击
kloof	缺口
kluge	聪明的
klutz	笨拙的人
knags	恶棍
knaps	骗子
knarl	克鲁尔
knars	嚼
knaur	克努尔
knawe	克纳威
knees	膝盖
knell	丧钟
knish	克尼什
knits	编织
knive	刀
knobs	旋钮
knops	按钮
knosp	按钮
knots	结
knout	诺特
knowe	知道
knows	知道
knubs	努布斯
knurl	滚花
knurr	滚花
knurs	滚花
knuts	克努特
koans	科恩
koaps	哄骗
koban	科万
kobos	科沃斯
koels	冷藏
koffs	科夫斯
kofta	软件
kogal	煤
kohas	在
kohen	科恩
kohls	科尔
koine	科恩
kojis	切
kokam	焦炭
kokas	焦炭
koker	科克
kokra	科克拉
kokum	库姆
kolas	轮子
kolos	科洛斯
kombu	命令
konbu	服务
kondo	公寓
konks	钩
kooks	怪人
kooky	古怪的
koori	唱诗班
kopek	科佩克
kophs	科夫
kopje	复制
koppa	科帕
korai	早期的
koras	可兰经
korat	科拉特
kores	科尔斯
korma	王冠
koros	年龄
korun	王冠
korus	科鲁斯
koses	科斯
kotch	科奇
kotos	科托斯
kotow	猫
koura	库拉
kraal	克拉尔
krabs	克拉布斯
kraft	卡夫
krais	克莱斯
krait	克莱特
krang	克朗
krans	克兰斯
kranz	花环
kraut	德国佬
krays	克雷斯
kreep	绉纱
kreng	克伦
krewe	血
krona	克朗
krone	克朗
kroon	克朗
krubi	血
krunk	克鲁克
ksars	克萨尔
kubie	库比
kudos	荣誉
kudus	库德斯
kudzu	葛根
kufis	库菲斯
kugel	球
kuias	怎样
kukri	库克里
kukus	玉米
kulak	库拉克
kulan	球
kulas	库拉斯
kulfi	印度冰淇淋
kumis	尺寸
kumys	马奶酒
kuris	谁
kurre	从未
kurta	卡
kurus	燃料
kusso	库索
kutas	库塔斯
kutch	卡奇
kutis	伙计
kutus	库图斯
kuzus	隐藏
kvass	克瓦斯
kvell	扼杀
kwela	这个
kyack	凯克
kyaks	凯克斯
kyang	京
kyars	凯尔斯
kyats	缅元
kybos	基博斯
kydst	射击
kyles	凯尔斯
kylie	凯莉
kylin	村庄
kylix	凯利克斯
kyloe	基洛
kynde	肯德
kynds	肯兹
kypes	塞普斯
kyrie	凯莉
kytes	凯茨
kythe	基特
laari	拉里
labda	球
labia	阴唇
labis	阴唇
labra	拉布拉
laced	系带
lacer	蕾丝
laces	鞋带
lacet	牛奶
lacey	莱西
lacks	缺乏
laddy	小姐
laded	舀
lader	装载机
lades	莱德斯
laers	小时
laevo	拉沃
lagan	层
lahal	邮件
lahar	包含
laich	低的
laics	来客
laids	莱兹
laigh	降低
laika	时间
laiks	时间
laird	莱尔德
lairs	巢穴
lairy	俗人
laith	颜色
laity	俗世信徒
laked	湖泊
laker	湖人队
lakes	湖泊
lakhs	拉克斯
lakin	常见的
laksa	拉克萨
laldy	拉尔迪
lalls	小角激光光散射
lamas	喇嘛
lambs	羔羊
lamby	羔羊
lamed	跛脚的
lamer	拉默
lames	跛脚的
lamia	拉米亚
lammy	羔羊
lamps	灯
lanai	拉奈
lanas	羊毛
lanch	兰奇
lande	国家
lands	土地
lanes	车道
lanks	瘦长的
lants	兰茨
lapin	兔子
lapis	青金石
lapje	补丁
larch	落叶松
lards	猪油
lardy	拉迪
laree	拉雷
lares	猪油
largo	拉戈
laris	喉
larks	云雀
larky	云雀
larns	云雀
larnt	朗特
larum	拉勒姆
lased	射击
laser	激光
lases	班
lassi	拉西
lassu	拉苏
lassy	拉西
lasts	持续
latah	背景
lated	Lated
laten	拉滕
latex	乳胶
lathi	其他的
laths	板条
lathy	拉齐
latke	拿铁
latus	拉图斯
lauan	桌子
lauch	劳奇
lauds	赞美
laufs	运行
laund	劳恩德
laura	劳拉
laval	拉瓦尔
lavas	熔岩
laved	薰衣草
laver	紫菜
laves	拉维斯
lavra	采矿
lavvy	拉维尤
lawed	法律
lawer	许多的
lawin	草坪
lawks	草坪
lawns	草坪
lawny	熔岩
laxed	松懈的
laxer	宽松的
laxes	松懈
laxly	莎蒙利
layed	层
layin	躺着。
layup	上篮
lazar	拉扎尔
lazed	懒散的
lazes	懒散的
lazos	债券
lazzi	拉齐
lazzo	懒惰的
leads	引导
leady	含铅的
leafs	树叶
leaks	泄漏
leams	利姆斯
leans	倾斜
leany	瘦削的
leaps	跳跃
leare	李尔王
lears	李尔王
leary	利里
leats	皮革
leavy	利维
leaze	租赁
leben	居住
leccy	容易的
ledes	是
ledgy	莱迪
ledum	勒杜
leear	空的
leeks	韭菜
leeps	打盹儿
leers	利尔斯
leese	阅读
leets	利兹
leeze	阅读
lefte	左边
lefts	左撇子
leger	玩
leges	法律
legge	法律
leggo	我读了
legit	正统剧
lehrs	教学
lehua	乐华
leirs	莱尔斯
leish	利什
leman	莱曼
lemed	柠檬
lemel	删除
lemes	阅读
lemma	引理
lemme	我们不是
lends	出借
lenes	莱恩斯
lengs	冷
lenis	镜头
lenos	雷诺
lense	透镜
lenti	镜头
lento	缓慢的
leone	利昂
lepid	莱皮德
lepra	麻风病
lepta	莱塔
lered	排
leres	阅读
lerps	勒普斯
lesbo	莱斯波
leses	阅读
lests	最后的
letch	莱奇
lethe	莱思
letup	休止
leuch	卢赫
leuco	淡色
leuds	滑动
leugh	躺
levas	莱瓦斯
levee	河堤
leves	汤
levin	莱文
levis	左边
lewis	刘易斯
lexes	阅读
lexis	莱克西斯
lezes	莱兹
lezza	莱扎
lezzy	莱西
liana	莉安娜
liane	莉安娜
liang	梁
liard	骗子
liars	骗子
liart	野生的
liber	自由的
libra	天秤座
libri	书
lichi	里奇
licht	光
licit	合法的
licks	舔
lidar	激光雷达
lidos	丽都
liefs	爱
liens	留置权
liers	谎言
lieus	代
lieve	亲爱的
lifer	生命
lifes	生活
lifts	举起
ligan	利根
liger	光
ligge	放置
ligne	线路
liked	喜欢
liker	喜欢
likes	喜欢
likin	利金
lills	小的
lilos	丁香花
lilts	轻快的
liman	五
limas	五
limax	利马克斯
limba	语言
limbi	林比
limbs	四肢
limby	利比
limed	石灰
limen	黎明
limes	酸橙
limey	利米
limma	胶
limns	莱姆斯
limos	豪华轿车
limpa	清洁的
limps	跛行
linac	直线加速器
linch	关键
linds	林德斯
lindy	林迪
lined	有内衬的
lines	线
liney	线
linga	语言
lings	林
lingy	周
linin	里宁
links	链接
linky	链接
linns	林斯
linny	林尼
linos	利诺斯
lints	磁带
linty	丝带
linum	利纳姆
lions	狮子
lipas	盒子
lipes	利普斯
lipin	利平
lipos	脂肪
lippy	口红的
liras	里拉
lirks	里克斯
lirot	里洛特
lisks	lisx
lisle	莱尔
lisps	口齿不清
lists	清单
litai	李泰
litas	升
lited	莱特
liter	公升
lites	升
litho	立陶宛
liths	石
litre	升
lived	生活
liven	活跃
lives	生活
livor	颜色
livre	书籍
llano	拉诺
loach	泥鳅
loads	荷载
loafs	面包
loams	壤土
loans	贷款
loast	厌恶
loave	游手好闲
lobar	大叶
lobed	浅裂的
lobes	肺叶
lobos	狼
lobus	耳垂
loche	孔
lochs	湖泊
locie	航班
locis	地点
locks	锁
locos	疯狂的
locum	蝗虫
loden	山猫
lodes	矿脉
loess	黄土
lofts	左边
logan	洛根
loges	更衣室
loggy	圆木
logia	罗吉亚
logie	罗吉
logoi	标识
logon	登录
logos	标识
lohan	标题
loids	多倍体
loins	腰部
loipe	追踪
loirs	闲逛
lokes	洛克斯
lolls	懒散的
lolly	棒棒糖
lolog	洛洛格
lomas	休息
lomed	洛美
lomes	名字
loner	孤独者
longa	长的
longe	朗格
longs	渴望
looby	鲁比
looed	流血
looey	鲁伊
loofa	露法
loofs	笨蛋
looie	单宁
looks	看
looky	瞧
looms	隐现
loons	疯子
loony	疯子
loops	循环
loord	鲁德
loots	掠夺
loped	大步走
loper	洛珀
lopes	洛佩斯
loppy	洛皮
loral	颜色
loran	罗兰
lords	贵族
lordy	天哪
lorel	洛雷尔
lores	眼先
loric	洛里克
loris	洛里斯
losed	失败者
losel	洛塞尔
losen	释放
loses	失去
lossy	有损
lotah	洛塔
lotas	一批
lotes	批
lotic	洗液
lotos	洛托斯
lotsa	洛萨
lotta	洛塔
lotte	乐天
lotto	大乐透
lotus	莲花
loued	灰色
lough	洛夫
louie	路易
louis	路易斯
louma	卢马
lound	朗德
louns	休息室
loupe	放大镜
loups	笨蛋
loure	颜色
lours	百叶窗
loury	卢利
louts	笨蛋
lovat	爱慕
loved	爱
loves	爱
lovey	法律
lovie	爱
lowan	洛万
lowed	降低
lowes	洛斯
lownd	低的
lowne	洛恩
lowns	劳恩斯
lowps	低声
lowry	洛瑞
lowse	洛斯
lowts	洛茨
loxed	勒克斯
loxes	盒
lozen	放电
luach	价值
luaus	卢奥斯
lubed	润滑
lubes	润滑油
lubra	卢布拉
luces	卢斯
lucks	幸运的
lucre	幸运
ludes	路德斯
ludic	荒谬的
ludos	游戏
luffa	丝瓜
luffs	雪橇
luged	光
luger	舱口
luges	雪橇
lulls	平静
lulus	卢卢斯
lumas	卢马
lumbi	海豚
lumme	卢姆
lummy	亲爱的。
lumps	肿块
lunas	月亮
lunes	星期一
lunet	挡板
lungi	长的
lungs	肺
lunks	伦克斯
lunts	伦茨
lupin	卢平
lured	引诱
lurer	诱饵
lures	诱惑
lurex	卢莱克斯
lurgi	鲁奇
lurgy	鲁奇
lurks	潜伏
lurry	勒里
lurve	勒夫
luser	虱子
lushy	郁郁葱葱的
lusks	卢克斯
lusts	欲望
lusus	卢修斯
lutea	琵琶
luted	琵琶
luter	物体
lutes	琵琶
luvvy	卢维
luxed	Luxed
luxer	奢侈品
luxes	奢侈品
lyams	莱姆斯
lyard	李亚德
lyart	莱亚特
lyase	裂解酶
lycea	莱西亚
lycee	莱西
lycra	莱卡
lymes	莱姆斯
lynes	闪电
lyres	七弦琴
lysed	照亮
lyses	光
lysin	光
lysis	溶解
lysol	（Lysol）利洁时集团的注册商标
lyssa	莱萨
lyted	声音
lytes	莱茨
lythe	莱特
lytic	溶解的
lytta	听
maaed	土地
maare	马尔
maars	但是
mabes	梅布斯
macas	担架
maced	猛击
macer	梅瑟
maces	钉头槌
mache	马赫
machi	马奇
machs	马赫数
macks	麦克
macle	梅克尔
macon	梅肯
madge	马奇
madid	蛇
madre	母亲
maerl	梅尔
mafic	黑手党的
mages	法师
maggs	马格斯
magot	种子
magus	魔法师
mahoe	马霍
mahua	麻花
mahwa	马赫瓦
maids	女佣
maiko	五月
maiks	五月
maile	邮寄
maill	梅勒
mails	邮件
maims	残废
mains	干线
maire	市长
mairs	梅尔
maise	玉米
maist	五月
makar	三月
makes	使
makis	马克斯
makos	马科斯
malam	夜
malar	马尔
malas	坏的
malax	马拉克斯
males	男性
malic	苹果的
malik	小的
malis	恶意
malls	商场
malms	马尔姆斯
malmy	马尔玛
malts	麦芽
malty	麦芽糖
malus	马吕斯
malva	脏兮兮的。
malwa	事件
mamas	玛丽露
mamba	黑曼巴
mamee	奶妈
mamey	玛米
mamie	奶奶
manas	玛纳斯
manat	马纳特
mandi	淋浴
maneb	曼尼布
maned	鬃毛
maneh	马内
manes	鬃毛
manet	马奈
mangs	芒斯
manis	甜蜜的
manky	男性
manna	吗哪
manos	手
manse	豪斯
manta	曼塔
manto	披风
manty	螳螂
manul	手册
manus	马努斯
mapau	地图
maqui	马基
marae	玛雷
marah	愤怒的
maras	海
marcs	马尔克斯
mardy	星期二
mares	海洋
marge	玛吉
margs	边缘
maria	玛丽亚
marid	马里兹
marka	标志
marks	标志
marle	泥灰岩
marls	泥灰
marly	玛丽
marms	马姆斯！
maron	马龙
maror	马罗
marra	线
marri	玛丽
marse	三月
marts	三月
marvy	马维
masas	群众
mased	群众
maser	脉泽
mases	群众
mashy	糊状的
masks	面具
massa	马萨
massy	群众
masts	桅杆
masty	软膏
masus	群众
matai	视野
mated	交配
mater	母校
mates	伙伴们
maths	数学
matin	上午
matlo	马特洛
matte	磨砂
matts	床垫
matza	文本
matzo	马特佐
mauby	毛比
mauds	莫兹
mauls	猛击
maund	攀登
mauri	摩尔人
mausy	莫西
mauts	老鼠
mauzy	莫兹
maven	专家
mavie	嫉妒
mavin	蓝色
mavis	三月
mawed	无效的
mawks	令人作呕
mawky	猴子
mawns	体积
maxed	最大化
maxes	最大值
maxis	马克西
mayan	玛雅人
mayas	玛雅人
mayed	梅耶德
mayos	五月
mayst	梅斯特
mazed	迷茫
mazer	马泽尔
mazes	迷宫
mazey	基本的
mazut	马祖特
mbira	美好的
meads	米德
meals	餐
meane	梅恩
means	方法
meany	意义
meare	更多
mease	米斯
meath	肉
meats	肉
mebos	梅博斯
mechs	机械师
mecks	梅克斯
medii	媒体
medle	梅德尔
meeds	米德
meers	湖
meets	遇见
meffs	梅夫斯
meins	矿
meint	思考
meiny	矿
meith	大小
mekka	梅卡
melas	梅尔
melba	梅尔巴
melds	信息
melic	梅利克
melik	梅尔克
mells	熔化
melts	融化
melty	梅尔蒂
memes	模因
memos	备忘录
menad	修补
mends	修补
mened	分钟
menes	闵
menge	量
mengs	门格斯
mensa	门萨
mense	复发月份第页
mensh	消息
menta	造币厂
mento	预计起飞时间
menus	菜单
meous	梅厄斯
meows	喵喵叫
merch	货物
mercs	美塞苔丝
merde	该死的
mered	梅里德
merel	梅丽尔
merer	更多
meres	梅尔斯
meril	标准
meris	梅里斯
merks	梅克斯
merle	梅尔
merls	标签
merse	谢谢
mesal	消息
mesas	台面
mesel	例子
meses	月
meshy	网状的
mesic	月份
mesne	肉
meson	介子
messy	凌乱的
mesto	城市
meted	计量
metes	计量器
metho	排
meths	冰毒
metic	精细的
metif	梅蒂夫
metis	梅蒂斯
metol	甲基
metre	米
meuse	默兹
meved	梅维德
meves	矿
mewed	喵喵叫
mewls	哭声
meynt	梅恩特
mezes	泽西
mezze	一半
mezzo	中音
mhorr	莫尔
miaou	矿山
miaow	苗族
miasm	肉
miaul	五月
micas	老鼠
miche	偷窃
micht	米希特
micks	米克斯
micky	米奇
micos	老鼠
micra	米卡拉
middy	正中的
midgy	侏儒的
midis	中等的
miens	闵
mieve	米维
miffs	米夫斯
miffy	米菲
mifty	打开
miggs	米格斯
mihas	Mihas
mihis	五月
miked	麦克风
mikes	麦克风
mikra	米卡拉
mikva	迈克
milch	挤奶
milds	温和的
miler	英里
miles	英里
milfs	米尔夫
milia	米莉亚
milko	鲜奶
milks	牛奶
mille	米勒
mills	磨坊
milor	密耳
milos	米洛斯
milpa	米尔巴
milts	米尔特
milty	米莉
miltz	米尔茨
mimed	模仿
mimeo	美眉
mimer	米默
mimes	哑剧
mimsy	哑剧
minae	矿山
minar	闵
minas	米纳斯
mincy	米西
minds	头脑
mined	挖掘
mines	矿山
minge	去
mings	铭刻
mingy	周
minis	迷你
minke	缟鳁鲸
minks	水貂
minny	米妮
minos	米诺斯
mints	薄荷糖
mired	陷入困境
mires	泥潭
mirex	灭蚁灵
mirid	无数
mirin	米林
mirks	泥泞
mirky	奇迹
mirly	泥泞
miros	气味
mirvs	米尔维斯
mirza	措施
misch	混合的
misdo	过失
mises	米塞斯
misgo	米斯戈
misos	味噌
missa	群众
mists	薄雾
misty	多雾的
mitch	米奇
miter	斜接
mites	螨虫
mitis	米提
mitre	斜接
mitts	手套
mixed	混合的
mixen	混合
mixer	搅拌机
mixes	混合
mixte	混合
mixup	混淆
mizen	米泽
mizzy	米兹
mneme	意见
moans	呻吟
moats	护城河
mobby	暴徒
mobes	手机
mobey	可移动的
mobie	莫比
moble	莫布尔
mochi	麻糬
mochs	摩卡
mochy	权力
mocks	嘲笑
moder	摩登
modes	模式
modge	莫奇
modii	莫迪
modus	方式
moers	母亲
mofos	莫弗斯
moggy	莫吉
mohel	莫希尔
mohos	莫霍
mohrs	莫尔斯
mohua	默化
mohur	莫胡尔
moile	莫尔
moils	莫尔
moira	莫伊拉
moire	云纹
moits	莫伊特
mojos	莫霍斯
mokes	烟
mokis	莫基斯
mokos	莫科斯
molal	臼齿
molas	摩尔
molds	铸模
moled	骚扰
moles	鼹鼠
molla	春天
molls	莫尔斯
molly	莫莉
molto	非常
molts	蜕皮
molys	分子
momes	微光机电系统
momma	妈妈
mommy	妈妈
momus	妈妈
monad	单子
monal	单子的
monas	周一
monde	世界
mondo	世界
moner	硬币
mongo	蒙戈
mongs	蒙斯
monic	一元论的
monie	周一
monks	僧侣
monos	莫诺斯
monte	蒙特
monty	蒙蒂
moobs	穆布斯
mooch	穆奇
moods	情绪
mooed	哞哞叫
mooks	穆克斯
moola	鼹鼠
mooli	鼹鼠
mools	沼地
mooly	穆利
moong	月亮
moons	月亮
moony	月光的
moops	驼背
moors	沼地
moory	穆里
moots	模拟
moove	动机
moped	轻便摩托车
moper	闷闷不乐
mopes	闷闷不乐
mopey	莫比
moppy	拖沓的
mopsy	莫西
mopus	全部
morae	莫拉
moras	莫拉斯
morat	莫拉特
moray	马里
morel	羊肚菌
mores	风俗习惯
moria	莫里亚
morne	莫恩
morns	早晨
morra	死亡
morro	莫罗
morse	莫尔斯
morts	死亡
mosed	莫斯德
moses	摩西
mosey	莫西
mosks	莫斯
mosso	变模糊
moste	桥
mosts	大多数
moted	微粒
moten	莫顿
motes	微粒
motet	莫特
motey	汽车旅馆
moths	飞蛾
mothy	飞蛾
motis	理由
motte	莫特
motts	莫茨
motty	莫蒂
motus	莫图斯
motza	类型
mouch	穆奇
moues	穆斯
mould	模具
mouls	蜕皮
moups	莫普斯
moust	莫斯特
mousy	老鼠
moved	感动的
moves	移动
mowas	莫瓦斯
mowed	割草
mowra	演讲
moxas	莫克斯
moxie	莫西
moyas	莫亚斯
moyle	莫伊尔斯
moyls	莫伊尔斯
mozed	莫扎德
mozes	莫兹
mozos	男孩们
mucho	很多
mucic	音乐
mucid	粘液
mucin	粘蛋白
mucks	淤泥
mucor	大小
mucro	穆克罗
mudge	泥巴
mudir	改变
mudra	穆德拉
muffs	马弗
mufti	穆夫提
mugga	杯子
muggs	杯子
muggy	闷热的
muhly	杯子
muids	缪德
muils	鼠标
muirs	缪尔
muist	其他的
mujik	国际的
muled	骡子
mules	骡子
muley	穆利。
mulga	马尔加
mulie	穆莉
mulla	土壤
mulls	沉思
mulse	骡子
mulsh	马尔什
mumms	木乃伊
mumps	流行性腮腺炎
mumsy	妈妈
mumus	乌姆斯
munga	蒙加
munge	咀嚼
mungo	芒戈
mungs	蒙格斯
munis	穆尼斯
munts	分钟
muntu	没人
muons	μ介子
muras	墙
mured	默德
mures	担心的
murex	穆雷克斯
murid	穆里德
murks	阴暗的
murls	墨尔斯
murly	默里
murra	画
murre	默尔
murri	死亡
murrs	穆尔
murry	默里
murti	死亡
murva	黑刺
musar	训诲
musca	麝香
mused	沉思
muser	老鼠
muses	缪斯
muset	不得不
musha	穆沙
musit	音乐家
musks	麝香
musos	穆索斯
musse	麝香
mussy	混乱的
musth	穆斯
musts	必须
mutch	是 啊。
muted	减轻的
muter	静音
mutes	沉默
mutha	沉默
mutis	知更鸟
muton	穆顿
mutts	杂种狗
muxed	混乱的
muzak	音乐
muzzy	模糊的
myall	迈尔
mylar	聚酯薄膜
mynah	八哥
mynas	八哥
myoid	肌样
myoma	肌瘤
myope	近视
myops	迈奥普斯
myopy	近视的
mythi	神话
myths	神话
mythy	神话
myxos	粘液
naams	名称
naans	纳安人
nabes	纳布斯
nabis	夜
nabks	夜晚
nabla	纳布拉
nabob	纳博布
nache	纳什
nacho	烤干酪辣味玉米片
nacre	珍珠层
nadas	鳍
naeve	雪
naevi	奈维
nagas	纳加斯
naggy	大的
nagor	纳戈尔
nahal	纳哈尔
naiad	奈德
naifs	侏儒
naiks	奈克斯
nails	钉子
naira	奈良
nairu	奈拉
naked	裸体的
naker	纳克尔
nakfa	取消
nalas	在里面
naled	纳尔德
nalla	泰迪熊
named	命名的
namer	名字
names	名字
namma	名称
namus	家
nanas	纳帕
nance	南斯
nancy	南希
nandu	南都
nanna	娜娜
nanos	纳米
nanua	%1毫瓦
napas	呼吸、胸部和纵隔疾病
naped	午睡
napes	午睡
napoo	纳布
nappa	纳帕
nappe	尿布
nappy	尿布
naras	奈拉斯
narco	毒品
narcs	毒品
nards	纳兹
nares	成员
naric	纳里奇
naris	成员
narks	药物
narky	药物
narre	傻瓜
nashi	纳什
natch	纳奇
nates	纳茨
natis	纳蒂斯
natty	整洁时髦的
nauch	恶心
naunt	恶心的
navar	纳瓦尔
naves	中堂
navew	纳维
navvy	纳维
nawab	纳瓦布
nazes	纳粹党
nazir	纳齐尔
nazis	纳粹分子
nduja	淋浴
neafe	侄子
neals	尼尔
neaps	纳秒
nears	最近的
neath	尼思
neats	尼茨
nebek	天空
nebel	雾
necks	脖子
neddy	内迪
needs	需要
neeld	古老的
neele	吞咽
neemb	年
neems	拿
neeps	及胡萝卜
neese	不
neeze	要求
negro	黑人
negus	内格斯
neifs	NFS
neist	其中
neive	奈维
nelis	内利斯
nelly	耐莉
nemas	没有什么
nemns	NEMNS
nenes	女孩们
neons	尼昂斯
neper	内珀
nepit	不要喝酒
neral	将军
nerds	书呆子
nerka	肾
nerks	书呆子
nerol	尼禄
nerts	书呆子
nertz	纳茨
nervy	神经
nests	巢穴
netes	内茨
netop	只是
netts	网
netty	内蒂
neuks	性交
neume	云
neums	纽姆斯
nevel	新的
neves	著名的
nevus	痣
newbs	新手
newed	新的
newel	新的
newie	新的
newsy	新鲜的
newts	蝾螈
nexts	奈克斯
nexus	关系
ngana	通过
ngati	缓慢的
ngoma	过渡期
ngwee	恩威
nicad	尼卡
nicht	不
nicks	尼克
nicol	尼科尔
nidal	巢穴
nided	没有人
nides	奈德
nidor	鸟巢
nidus	巢穴
niefs	尼夫斯
nieve	雪
nifes	尼维斯
niffy	漂亮的
nifty	漂亮的
niger	尼日尔
nighs	黑人
nihil	尼希尔
nikab	尼卡布
nikah	结婚
nikau	尼考
nills	尼尔斯
nimbi	宁比
nimbs	光环
nimps	尼姆普斯
niner	九
nines	九
ninon	尼农
nipas	尼帕斯
nippy	太冷了
niqab	优先
nirls	尼尔斯
nirly	涅利
nisei	尼塞
nisse	圣诞老人
nisus	尼苏斯
niter	尼特
nites	尼特斯
nitid	尼蒂
niton	尼顿
nitre	硝化物
nitro	硝基
nitry	尼特里
nitty	本质
nival	水平
nixed	否决
nixer	尼克斯
nixes	乳头
nixie	尼克西
nizam	尼加拉瓜
nkosi	密码
noahs	诺亚
nobby	诺比
nocks	诺克斯
nodal	节的
noddy	诺迪
nodes	节点
nodus	诺德斯
noels	诺尔斯
noggs	诺格斯
nohow	不知道
noils	落麻
noily	讨厌的
noint	诺因
noirs	黑色
noles	零
nolls	零
nolos	诺洛斯
nomas	诺马斯
nomen	名称
nomes	名字
nomic	经济的
nomoi	名字
nomos	名字
nonas	九
nonce	暂时的
nones	九
nonet	九
nongs	农
nonis	无
nonny	诺尼
nonyl	壬基酚
nooit	从未
nooks	角落
nooky	阴暗的
noons	中午
noops	努普斯
nopal	诺帕尔
noria	诺莉亚
noris	也不是
norks	诺克斯
norma	正常的
norms	规范
nosed	鼻子
noser	鼻子
noses	鼻子
notal	诺塔尔
noted	注意
noter	笔记
notes	笔记
notum	诺顿
nould	诺尔德
noule	新的
nouls	努尔斯
nouns	名词
nouny	_其他组织者
noups	没有人
novae	新星
novas	新的
novum	新的
noway	不
nowed	新的
nowls	诺尔斯
nowts	诺茨
nowty	诺蒂
noxal	Noxal
noxes	诺克斯
noyau	核心
noyed	新的
noyes	坚果
nubby	块状的
nubia	云
nucha	努查
nuddy	裸体的
nuder	努德
nudes	裸体
nudie	裸体
nudzh	无聊
nuffs	努夫
nugae	诺盖
nuked	核武器
nukes	核武器
nulla	无效的
nulls	空值
numbs	麻木的
numen	努曼人
nummy	数字
nunny	尼姑
nurds	托儿所
nurdy	托迪
nurls	NURLS公司
nurrs	努尔斯
nutso	坚果
nutsy	疯子
nyaff	尼亚夫
nyala	尼亚拉
nying	尼因
nyssa	只是
oaked	橡树
oaker	橡树
oakum	麻絮
oared	划桨
oases	绿洲
oasis	绿洲
oasts	部分
oaten	奥廷
oater	奥特
oaths	誓言
oaves	绿洲
obang	或
obeah	奥贝
obeli	奥贝里
obeys	服从
obias	奥比亚斯
obied	奥比德
obiit	讣告
obits	讣告
objet	目的
oboes	双簧管
obole	双簧管
oboli	奥博利
obols	欧布尔
occam	奥卡姆
ocher	赭石色
oches	赭石
ochre	赭石色
ochry	赭石色
ocker	赭石色
ocrea	赭石
octad	字节
octan	醋酸盐
octas	八进制
octyl	辛基
oculi	奥克利
odahs	奥达斯
odals	奥达尔
odeon	奥多内
odeum	奥迪姆
odism	厌恶
odist	憎恶者
odium	憎恶
odors	气味
odour	气味
odyle	奥黛尔
odyls	奥德尔斯
ofays	当然。
offed	提供
offie	离线
ofter	经常
ogams	奥加姆斯
ogeed	ogede
ogees	奥吉斯
oggin	奥金
ogham	奥格姆
ogive	奥吉夫
ogled	凝视
ogler	和
ogles	凝视
ogmic	食人魔
ogres	食人魔
ohing	哦
ohmic	欧姆的
ohone	从
oidia	水肿
oiled	上油
oiler	加油器
oinks	奥克斯
oints	点数
ojime	眼睛
okapi	奥卡皮
okays	奥凯
okehs	好 啊
okras	秋葵
oktas	奥克特
oldie	老歌
oleic	油酸的
olein	油酸
olent	存在
oleos	油
oleum	油膏
olios	奥利奥
ollas	奥利斯
ollav	奥利夫
oller	奥利
ollie	奥利
ology	生物学
olpae	奥尔帕
olpes	奥尔普斯
omasa	奥马萨
omber	阴影
ombus	影子
omens	预兆
omers	奥马尔
omits	省略
omlah	天哪
omovs	奥莫斯
omrah	乌姆拉
oncer	一次
onces	盎司
oncet	一旦
onely	唯一的
oners	奴隶
onery	繁重的
onium	奥尼姆
onkus	昂库斯
onlay	仅限
onned	奥奈德
oobit	奥比特
oohed	流出
oomph	魅力
oonts	奥茨
ooped	哎呀
oorie	小时
ooses	粪便
ootid	奥茨
oozed	渗出
oozes	渗出
opahs	奥帕斯
opals	蛋白石
opens	打开
opepe	欧佩普
oping	投掷者
oppos	相反的
opsin	选项
opted	选择
opter	奥普特
orach	神谕
oracy	小时
orals	口头禅
orang	人
orant	奥兰特
orate	布雷姆
orbed	吸收
orcas	奥卡斯
orcin	虎鲸素
ordos	鄂尔多斯
oread	奥利德
orfes	奥菲斯
orgia	狂欢
orgic	狂欢
orgue	风琴
oribi	奥利比
oriel	奥利尔
orixa	来源
orles	小时
orlon	奥龙
orlop	奥洛普
ormer	形式
ornis	星期一
orpin	奥平
orris	页面
ortho	正交
orval	以前的
orzos	奥佐斯
oscar	奥斯卡
osier	柳条
osmic	奥斯米克
osmol	奥斯莫尔
ossia	即
ostia	奥斯蒂亚
otaku	我的大脑
otary	奥塔里
ottar	奥塔
ottos	奥托斯
oubit	乌比特
oucht	哎哟
ouens	尤恩斯
ouija	占卜术
oulks	乌鸦
oumas	乌玛斯
oundy	奥迪
oupas	乌帕斯
ouped	哎哟
ouphe	乌普赫
ouphs	欧普斯
ourie	乌里
ousel	乌塞尔
ousts	驱逐
outby	奥特比
outed	暴露
outre	出局
outro	其他
outta	离开
ouzel	取消
ouzos	乌佐斯
ovals	椭圆形
ovels	烤箱
ovens	烤箱
overs	结束
ovist	羊毛的
ovoli	奥沃利
ovolo	奥沃洛
ovule	胚珠
owche	哎哟
owies	选项
owled	猫头鹰
owler	猫头鹰
owlet	猫头鹰
owned	拥有
owres	奥里斯
owrie	奥瑞
owsen	燕麦
oxbow	牛弓
oxers	公牛
oxeye	奥克西耶
oxids	氧化物
oxies	氧化物
oxime	肟
oxims	奥希姆斯
oxlip	牛唇
oxter	奥克斯特
oyers	听
ozeki	奥泽基
ozzie	奥齐
paals	贝尔
paans	路径
pacas	步调
paced	步测的
pacer	步行者
paces	步调
pacey	佩西
pacha	帕查
packs	打包
pacos	小包
pacta	帕塔
pacts	契约
padis	路径
padle	倒下的
padma	帕德玛
padre	父亲
padri	父亲
paean	赞歌
paedo	Paedo
paeon	赞歌
paged	呼叫
pager	寻呼机
pages	页
pagle	帕格尔
pagod	疲劳
pagri	帕格里
paiks	地点
pails	电邮
pains	痛苦
paire	配对
pairs	对
paisa	佩萨
paise	佩斯
pakka	包裹
palas	帕拉斯
palay	帕莱
palea	帕利亚
paled	苍白
pales	苍白
palet	调色板
palis	巴利斯
palki	日志
palla	球
palls	球
pally	帕利
palms	棕榈树
palmy	兴旺的
palpi	触须
palps	触须
palsa	帕尔萨
pampa	潘帕
panax	人参
pance	煎饼
panda	熊猫
pands	潘德斯
pandy	潘迪
paned	放
panes	窗格玻璃
panga	潘加
pangs	痛苦
panim	先生。
panko	银行
panne	崩溃
panni	布
panto	潘托
pants	内裤
panty	童裤
paoli	保利
paolo	保罗
papas	马铃薯
papaw	爸爸
papes	纸张大小
pappi	帕皮
pappy	帕皮
parae	停止
paras	段落
parch	使极干燥
pardi	鸭子
pards	帕德
pardy	帕迪
pared	削减
paren	帕伦
pareo	装置
pares	削减
pareu	帕鲁
parev	一对
parge	帕吉
pargo	段落
paris	巴黎
parki	停车场
parks	公园
parky	公园
parle	说话
parly	帕利
parma	帕尔玛
parol	单词
parps	帕尔普斯
parra	段落
parrs	帕尔斯
parti	理想配偶
parts	部分
parve	小的
parvo	愚蠢的
paseo	帕西奥
pases	帕斯
pasha	帕夏
pashm	帕什姆
paska	倒霉
paspy	帕西
passe	过去的
pasts	过去的
pated	脑袋
paten	专利
pater	佩特
pates	脑袋
paths	路径
patin	帕廷
patka	鸭子
patly	帕特利
patte	爪子
patus	帕图斯
pauas	暂停
pauls	%1磅
pavan	空的
paved	铺路的
paven	教皇
paver	摊铺机
paves	铺路
pavid	帕维德
pavin	帕文
pavis	帕维斯
pawas	爪子
pawaw	爪子
pawed	爪子
pawer	帕尔
pawks	爪子
pawky	孔雀
pawls	棘爪
pawns	典当
paxes	页
payed	支付
payor	付款人
peage	停止
peags	峰值
peaks	峰顶
peaky	峰
peals	皮尔斯
peans	花生
peare	梨
pears	梨
peart	港口
pease	豌豆
peats	泥炭
peaty	泥炭
peavy	皮维
pebas	佩巴斯
pechs	抛
pecke	抛
pecks	啄
pecky	饼干
pedes	脚
pedis	足部
pedro	石
peece	皮斯
peeks	偷看
peels	剥皮
peens	喷丸
peeoy	皮耶
peepe	偷窥
peeps	窥视
peers	同龄人
peery	皮
peeve	生气
peggy	佩吉
peghs	佩格斯
peins	油漆
peise	佩斯
peize	佩兹
pekan	星期
pekes	尖头
pekin	北京
pekoe	部分
pelas	通过
pelau	运动员
peles	皮肤
pelfs	毛皮
pells	距离
pelma	纸类
pelon	佩隆
pelta	领域
pelts	毛皮
pends	悬而未决
pendu	绞死
pened	佩内德
penes	阴茎
pengo	彭戈
penie	阴茎
penis	阴茎
penks	便士
penna	佩纳
penni	笔
pents	彭茨
peons	典当
peony	牡丹
pepla	佩普拉
pepos	佩波斯
peppy	活泼的
pepsi	百事可乐
perai	梨
perce	分钟
percs	分钟
perdu	迷路了
perdy	珀迪
perea	梨
peres	对
peris	佩里斯
perks	津贴
perms	烫发
perns	腿
perog	佩罗
perps	罪犯
perry	佩里
perse	百分比
perst	压榨
perts	珀斯
perve	佩尔维
pervo	变态儿
pervs	罪犯
pervy	变态的
pesos	比索
pests	害虫
pesty	害虫
petar	佩塔
peter	彼得
petit	佩蒂
petre	石
petri	佩特里
petti	佩蒂
petto	胸部
pewee	佩维
pewit	佩维特
peyse	乡间
phage	噬菌体
phang	潘
phare	法尔
pharm	法姆
pheer	费尔
phene	说
pheon	pheon。
phese	顶部
phial	小药瓶
phish	网络钓鱼
phizz	菲兹
phlox	福禄考
phoca	福卡
phono	电话
phuts	普茨
phyla	门
phyle	Phyl
piani	计划
pians	计划
pibal	皮巴尔
pical	皮卡尔
picas	异教徒
piccy	皮西
picks	挑选
picot	皮科
picra	披萨
picul	小的
piend	馅饼
piers	码头
piert	码头
pieta	皮埃塔
piets	页脚
piezo	压电
pight	皮格特
pigmy	小猪
piing	皮因
pikas	鼠兔
pikau	皮考
piked	派克
piker	派克
pikes	长矛
pikey	皮克
pikis	像素
pikul	像素
pilae	箭头
pilaf	肉饭
pilao	委顿
pilar	皮拉尔
pilau	皮劳
pilaw	皮劳
pilch	皮尔奇
pilea	箭头
piled	堆叠
pilei	裴磊
piler	箭
piles	痔疮
pilis	堆
pills	药丸
pilow	皮洛夫
pilum	菌毛
pilus	狭缝
pimas	皮姆
pimps	皮条客
pinas	闵
pined	憔悴
pines	松树
pings	ping
pinko	平子
pinks	粉红色
pinna	羽片
pinny	羽状的
pinon	皮农
pinot	比诺
pinta	品脱
pints	品脱
pinup	化妆
pions	棋子
piony	垂直的
pious	虔诚的
pioye	皮耶
pioys	皮奥斯
pipal	皮帕尔
pipas	皮帕斯
piped	管道
pipes	管
pipet	吸管
pipis	管
pipit	皮皮特
pippy	皮皮
pipul	管道
pirai	金字塔
pirls	皮尔斯
pirns	皮恩斯
pirog	皮罗格
pisco	皮斯科
pises	比萨
pisky	小气鬼
pisos	地板
pissy	小气鬼
piste	皮斯特
pitas	皮塔
piths	髓
piton	蟒蛇
pitot	皮托管
pitta	皮塔
piums	皮昂
pixes	像素
pized	皮兹
pizes	披萨
plaas	地点
plack	斑块
plage	范围
plans	计划
plaps	普拉普斯
plash	普拉斯
plasm	血浆
plast	塑料
plats	位置
platt	平台
platy	付款
playa	普拉亚
plays	演奏
pleas	恳求
plebe	请原谅
plebs	平民百姓
plena	空的
pleon	褶裥
plesh	垃圾
plews	请。
plica	皱襞
plies	层
plims	普利姆斯
pling	钉
plink	普林克
ploat	鳍
plods	沉重的
plong	扑通
plonk	扑通一声
plook	扑通一声
plops	扑通一声
plots	阴谋
plotz	情节
plouk	普卢克
plows	犁
ploye	雨
ploys	策略
plues	雨
pluff	加夫
plugs	塞子
plums	李子
plumy	羽毛
pluot	杏李
pluto	冥王星
plyer	普利耶
poach	水煮
poaka	波卡
poake	波克
poboy	人
pocks	透明斑
pocky	麻子
podal	通过
poddy	波迪
podex	可以
podge	豆荚
podgy	矮胖的
podia	能够
poems	诗
poeps	大便
poets	诗人
pogey	波吉
pogge	波格
pogos	波哥斯
pohed	波希德
poilu	波卢
poind	波因德
pokal	杯子
poked	戳
pokes	戳
pokey	可怜的
pokie	好 啊
poled	极化
poler	极点
poles	极点
poley	波利
polio	小儿麻痹症
polis	聚
polje	领域
polks	波尔克斯
polls	民意测验
polly	波利
polos	马球
polts	波尔茨
polys	多义词
pombe	鸽子
pomes	梨果
pommy	波米
pomos	波莫斯
pomps	炫耀
ponce	庞塞
poncy	小马
ponds	池塘
pones	你把
poney	小马
ponga	把
pongo	庞戈
pongs	乒乓球
pongy	乒乓球
ponks	庞克
ponts	要点
ponty	浮筒
ponzu	油漆
poods	商店
pooed	便便
poofs	便便
poofy	普菲
poohs	鱼缸
pooja	普亚
pooka	普卡
pooks	便便
pools	游泳池
poons	汤匙
poops	大便
poopy	可怜的
poori	毛孔
poort	港口
poots	普茨
poove	普维
poovy	便便
popes	教皇
poppa	船尾
popsy	波西
porae	慢点
pored	仔细研究
porer	轨道
pores	毛孔
porge	手
porgy	波吉
porin	孔蛋白
porks	猪肉
porky	猪
porno	色情片
porns	色情片
porny	色情片
porta	波尔塔
ports	港口
porty	胖乎乎的
posed	摆姿势
poses	摆姿势
posey	波西
posho	波绍
posts	帖子
potae	土豆
potch	水壶
poted	药水
potes	你可以
potin	锅
potoo	然后
potsy	土豆
potto	波托
potts	波茨
potty	琐碎的
pouff	波夫
poufs	虱子
pouke	教训
pouks	撅嘴
poule	母鸡
poulp	波尔普
poult	撅嘴
poupe	节约
poupt	撅嘴
pours	倾泻
pouts	撅嘴
powan	波万
powin	应该
pownd	鲍恩德
powns	鲍恩斯
powny	波兹尼
powre	鲍尔
poxed	Poxed
poxes	威尔斯
poynt	波因特
poyou	波尤
poyse	空的
pozzy	波西
praam	准备好了吗
prads	普拉兹
prahu	粉
prams	婴儿车
prana	普拉纳
prang	普拉格
praos	普拉斯
prase	猪
prate	唠叨
prats	普拉茨
pratt	普拉特
praty	猪
praus	粉
prays	祈祷
predy	出售
preed	梳理
prees	普里斯
preif	韭菜
prems	普莱姆斯
premy	普雷米
prent	打印
preon	普罗恩
preop	准备好的
preps	预科生
presa	紧握
prese	插座
prest	准备好的
preve	翻译
prexy	前世
preys	捕食
prial	普里亚尔
pricy	价格
prief	私人的
prier	祈祷
pries	撬
prigs	普里格斯
prill	普里尔
prima	主要的
primi	持有
primp	打扮
prims	拘谨的
primy	首要的
prink	普林克
prion	朊病毒
prise	撬开
priss	价格
proas	测试
probs	问题
prods	刺激
profs	教师
progs	进步
proin	普罗因
proke	项目
prole	无产者
proll	普罗尔
promo	宣传片
proms	舞会
pronk	炫耀
props	道具
prore	普罗雷
proso	普罗索
pross	普罗斯
prost	愚蠢的
prosy	小米
proto	因此
proul	普鲁尔
prows	船头
proyn	普鲁恩
prunt	普伦特
pruta	普鲁塔
pryer	牧师
pryse	乳房
pseud	假扮
pshaw	普肖
psion	心灵感应
psoae	腰肌
psoai	普赛
psoas	腰大肌
psora	腰肌
psych	心理学
psyop	心理战
pubco	公众的
pubes	阴毛
pubis	耻骨
pucan	浦坎
pucer	上升
puces	跳蚤
pucka	普卡
pucks	冰球
puddy	小胖子
pudge	泥
pudic	普迪克
pudor	普多
pudsy	矮胖的
pudus	普杜斯
puers	普尔斯
puffa	泡芙
puffs	泡芙
puggy	帕吉
pugil	拳击
puhas	清洁的
pujah	树
pujas	出价
pukas	普卡斯
puked	呕吐
puker	呕吐
pukes	呕吐物
pukey	恶心的
pukka	圣诞老人
pukus	适合
pulao	地点
pulas	跳跃
puled	脉冲
puler	脉冲
pules	脉冲
pulik	粘贴
pulis	普利斯
pulka	纸浆
pulks	脉冲
pulli	公牛
pulls	拉
pully	普鲁
pulmo	脉冲
pulps	纸浆
pulus	脉冲
pumas	美洲狮
pumie	美洲狮
pumps	泵
punas	要点
punce	女孩们
punga	袋
pungs	英镑
punji	朋吉语
punka	朋卡
punks	朋克
punky	朋克
punny	弱小的
punto	点
punts	平底船
punty	微不足道的
pupae	蛹
pupas	_密码：
pupus	蛹
purda	纯净的
pured	纯净的
pures	纯净的
purin	嘌呤
puris	普里斯
purls	咕噜声
purpy	紫色
purrs	呼噜声
pursy	钱包
purty	珀蒂
puses	聚会
pusle	呼吸
pussy	猫咪
putid	腐败的
puton	普顿
putti	普蒂
putto	推杆
putts	推杆
puzel	普泽尔
pwned	PWNED
pyats	皮亚茨
pyets	皮耶茨
pygal	皮加尔
pyins	皮因斯
pylon	电缆塔
pyned	皮恩
pynes	皮恩斯
pyoid	脓肿
pyots	侏儒
pyral	皮拉尔
pyran	皮兰
pyres	柴堆
pyrex	派热克斯
pyric	皮里奇
pyros	烟火
pyxed	皮克斯
pyxes	皮克斯
pyxie	Pyxie公司
pyxis	皮克斯
qadis	卡迪斯
qajaq	男性
qanat	船
qapik	链接
qibla	可接受的
qorma	团体
quads	四头肌
quaff	痛饮
quags	夸格
quair	奎尔
quais	哪一个
quaky	地震
quale	夸尔
quant	定量
quare	四
quass	卡斯
quate	夸特
quats	夸茨
quayd	广场
quays	码头
qubit	量子比特
quean	奎安
queme	烧
quena	昆娜
quern	交叉
queyn	奎恩
queys	奎斯
quich	奎奇
quids	英镑
quiff	吹毛求疵
quims	奎姆斯
quina	什么
quine	奎因
quino	奎诺
quins	昆斯
quint	昆特
quipo	基波
quips	俏皮话
quipu	奎普
quire	奎尔
quirt	怪癖
quist	奎斯特
quits	退出
quoad	关于
quods	库兹
quoif	商
quoin	角落
quoit	库伊特
quoll	袋鼬
quonk	昆克
quops	库普斯
qursh	Qursh
quyte	奎特
rabat	拉巴特
rabic	拉比
rabis	拉比
raced	比赛
races	比赛
rache	阅读
racks	架子
racon	拉肯
radge	拉奇
radix	基数
radon	氡
raffs	拉夫
rafts	木筏
ragas	拉加斯
ragde	排
raged	愤怒
ragee	Ragee
rager	剃刀
rages	愤怒
ragga	拉加
raggs	拉格斯
raggy	破烂的
ragis	破布
ragus	角
rahed	框架
rahui	拉胡伊
raias	半径
raids	突袭
raiks	雷克斯
raile	线
rails	轨道
raine	雷恩
rains	雨
raird	雷德
raita	轨道
raits	Raits公司
rajas	拉贾斯
rajes	裂缝
raked	耙
rakee	耙
raker	耙子
rakes	耙子
rakia	拉基亚
rakis	钥匙
rakus	拉库斯
rales	罗尔斯
ramal	拉马尔
ramee	拉米
ramet	分株
ramie	苎麻
ramin	拉明
ramis	框架
rammy	公羊
ramps	坡道
ramus	拉莫斯
ranas	拉纳斯
rance	兰斯
rands	兰兹
ranee	拉尼
ranga	兰加
rangi	颜色
rangs	军衔
rangy	瘦长的
ranid	拉尼德
ranis	拉尼斯
ranke	等级
ranks	等级
rants	咆哮
raped	强奸
raper	强奸者
rapes	强奸
raphe	中缝
rappe	强奸
rared	稀有的
raree	稀有的
rares	稀有的
rarks	拉克斯
rased	激怒
raser	拉瑟
rases	皮疹
rasps	锉刀
rasse	拉什
rasta	光栅
ratal	拉塔尔
ratan	拉坦
ratas	大鼠
ratch	棘轮
rated	估价
ratel	格格作响
rater	评分员
rates	费率
ratha	老鼠
rathe	旋转
raths	拉思
ratoo	鼠标
ratos	胡扯
ratus	拉特斯
rauns	圆
raupo	可用
raved	狂吠
ravel	使…缠绕
raver	拉威尔
raves	狂欢
ravey	拉维
ravin	峡谷
rawer	罗威尔
rawin	根
rawly	生硬的
rawns	罗恩斯
raxed	雷克斯
raxes	比赛
rayah	射线
rayas	条纹
rayed	光线
rayle	雷尔
rayne	雷恩
razed	夷为平地
razee	剃刀
razer	夷为平地
razes	夷为平地
razoo	拉佐
readd	里德
reads	读到
reais	真实的
reaks	收割
realo	领域
reals	雷亚尔
reame	真实的
reams	令
reamy	令
reans	销售
reaps	收获
rears	养育
reast	速率
reata	雷亚
reate	创造
reave	雷夫
rebbe	将
rebec	丽贝克
rebid	雷比德
rebit	雷比特
rebop	重新启动
rebuy	雷比
recal	重铸
recce	雷切
recco	雷科
reccy	雷西
recit	阅读
recks	记录
recon	侦察
recta	直肠
recti	直肠
recto	直肠
redan	已经
redds	雷德斯
reddy	红的
reded	运行
redes	网络
redia	雷迪亚
redid	雷迪德
redip	雷迪普
redly	红色的
redon	雷东
redos	圆
redox	氧化还原
redry	雷德利
redub	重播
redux	雷杜
redye	雷迪
reech	刺鼻
reede	星期五
reeds	芦苇
reefs	暗礁
reefy	暗礁
reeks	臭气熏天
reeky	臭气熏天
reels	卷轴
reens	林斯
reest	里斯特
reeve	里夫
refed	裁判
refel	回流
refly	弗莱
refry	合唱
regar	雷加
reges	国王
reggo	雷戈
regie	方向
regma	雷格玛
regna	雨
regos	规则
regur	雷格
rehem	雷厄姆
reifs	成熟
reify	具体化
reiki	灵气
reiks	需要
reink	莱因克
reins	缰绳
reird	板
reist	旅行
reive	雷夫
rejig	重新调整
rejon	雷洪
reked	回答
rekes	雷克斯
rekey	行
relet	转载
relie	链接
relit	重温
rello	雷洛
reman	雷曼
remap	重新映射
remen	雷门
remet	放回去
remex	雷米克斯
remix	混音
renay	名称
rends	撕裂
reney	雷尼
renga	连歌
renig	清洁的
renin	肾素
renne	运行
renos	驯鹿
rente	兴趣
rents	租金
reoil	再油
reorg	重组
repeg	雷佩格
repin	雷平
repla	日巴
repos	休息
repot	报告
repps	重复
repro	重新编程
reran	重播
rerig	重新开始
resat	雷萨特
resaw	雷索
resay	雷塞
resee	丽西
reses	里塞斯
resew	重置
resid	残余物
resit	重新开始
resod	决议
resow	重新考虑
resto	休息
rests	休息
resty	休息
retag	互联网
retax	雷塔克斯
retem	网
retia	雷蒂亚
retie	网络
retox	翻新
revet	里维特
revie	雷维
rewan	雷文
rewax	重做
rewed	重写
rewet	里维特
rewin	瑞恩
rewon	雷翁
rewth	回报
rexes	雷克斯
rezes	祈祷
rheas	瑞亚斯
rheme	述位
rheum	大黄
rhies	瑞斯
rhine	莱茵河
rhody	铑
rhomb	菱形
rhone	罗纳
rhumb	伦布
rhyne	行
rhyta	节奏
riads	里亚兹酒店
rials	里亚尔
riant	追踪
riata	里亚塔
ribas	边缘
ribby	跳过
ribes	肋骨
riced	大米
ricer	大米
rices	米饭
ricey	里奇
richt	正确的
ricin	蓖麻毒素
ricks	里克斯
rides	骑
ridgy	里奇
ridic	可笑的
riels	瑞尔
riems	河流
rieve	里夫
rifer	参考
riffs	即兴发挥
rifte	裂痕
rifts	裂痕
rifty	裂痕
riggs	里格斯
rigol	里戈
riled	激怒
riles	激怒
riley	莱利
rille	里尔
rills	小溪
rimae	押韵
rimed	镶边
rimer	押韵
rimes	押韵
rimus	边缘
rinds	果皮
rindy	排
rines	RINES公司
rings	戒指
rinks	溜冰场
rioja	里奥哈
riots	暴动
riped	撕裂
ripes	撕裂
ripps	撕裂
rises	升起
rishi	里希
risks	风险
risus	里苏斯
rites	仪式
ritts	骑
ritzy	豪华的
rivas	里瓦斯
rived	裂开
rivel	里维尔
riven	裂开
rives	河流
riyal	里亚尔
rizas	里萨斯
roads	道路
roams	漫游
roans	罗恩斯
roars	咆哮
roary	咆哮。
roate	车轮
robed	长袍
robes	长袍
roble	罗伯
rocks	岩石
roded	罗得
rodes	罗德斯
roguy	流氓的
rohes	排
roids	ROID
roils	翻滚
roily	喧闹。
roins	罗恩斯
roist	克鲁克
rojak	罗雅克
rojis	下雨
roked	罗克德
roker	罗克尔
rokes	罗克斯
rolag	罗拉格
roles	角色
rolfs	罗尔斯
rolls	卷
romal	罗马尔
roman	古罗马的
romeo	罗密欧
romps	嬉戏
ronde	圆
rondo	回旋曲
roneo	罗内奥
rones	朗斯
ronin	浪人
ronne	罗恩
ronte	正面
ronts	伦茨
roods	红色
roofs	屋顶
roofy	迷糊的
rooks	车
rooky	新手
rooms	房间
roons	红色
roops	鲁普斯
roopy	鲁比
roosa	粉红色
roose	玫瑰
roots	根
rooty	罗蒂
roped	套住
roper	罗珀
ropes	绳索
ropey	罗比
roque	罗克
roral	罗拉尔
rores	罗尔斯
roric	罗里克
rorid	罗里德
rorie	睡意
rorts	罗茨
rorty	罗蒂
rosed	玫瑰色
roses	玫瑰
roset	玫瑰
roshi	罗西
rosin	松香
rosit	红色
rosti	罗斯蒂
rosts	罗斯特
rotal	旋转的
rotan	老鼠
rotas	路径
rotch	罗奇
roted	死记硬背
rotes	红色
rotis	车轮
rotls	轮
roton	罗顿
rotos	破碎的
rotte	路线
rouen	红色
roues	红色
roule	滚动
rouls	轧辊
roums	罗马尼亚语
roups	群
roupy	粗野的
roust	罗斯特
routh	劳斯
routs	溃败
roved	漫游
roven	乌鸦
roves	漫游
rowan	罗文
rowed	划船
rowel	罗威尔
rowen	罗文
rowie	战壕
rowme	Rowme
rownd	罗恩
rowth	吵闹
rowts	罗茨
royne	罗恩
royst	罗伊斯特
rozet	粉红色
rozit	松香
ruana	鲁阿纳
rubai	红宝石
rubby	鲁比
rubel	卢布
rubes	卢布
rubin	红宝石
ruble	卢布
rubli	卢布
rubus	悬钩子
ruche	动作
rucks	帆布
rudas	红色
rudds	陆克文
rudes	粗糙的
rudie	鲁迪
rudis	鲁迪斯
rueda	车轮
ruers	吕斯
ruffe	皱褶
ruffs	皱褶
rugae	皱襞
rugal	鲁加尔
ruggy	粗犷
ruing	毁灭
ruins	废墟
rukhs	鲁克斯
ruled	统治
rules	规则
rumal	愚蠢的
rumbo	轴承
rumen	瘤胃
rumes	朗姆酒
rumly	隆隆
rummy	拉米
rumpo	伦波
rumps	臀部
rumpy	拉米
runch	朗奇
runds	轮
runed	伦德
runes	符文
rungs	横档
runic	北欧古字
runny	流鼻涕的
runts	矮子
runty	矮胖的
rupia	卢比
rurps	鲁普斯
rurus	鲁鲁
rusas	俄语
ruses	诡计
rushy	拉什
rusks	罗斯克斯
rusma	俄语
russe	俄语
rusts	生锈
ruths	露丝
rutin	芦丁
rutty	拉蒂
ryals	莱尔斯
rybat	鱼
ryked	莱克
rykes	莱克斯
rymme	容纳
rynds	兰兹
ryots	Ryots公司
ryper	赖珀
saags	小时
sabal	萨巴尔
sabed	萨贝德
saber	马刀
sabes	你知道的，
sabha	萨巴
sabin	萨宾
sabir	萨比尔
sable	黑貂
sabot	木托
sabra	萨布拉
sabre	佩剑
sacks	麻袋
sacra	萨克拉
saddo	萨多
sades	赛德斯
sadhe	萨德
sadhu	萨杜
sadis	萨迪斯
sados	萨多斯
sadza	萨扎
safed	采法特
safes	保险箱
sagas	传奇故事
sager	萨杰
sages	圣人
saggy	下垂的
sagos	西米
sagum	历史
saheb	萨赫布
sahib	萨希布
saice	大小
saick	赛克
saics	大小
saids	赛义德
saiga	赛加
sails	帆
saims	赛姆斯
saine	塞恩
sains	声音
sairs	外面的
saist	赛斯特
saith	说
sajou	萨朱
sakai	说
saker	东西
sakes	看在上帝的份上
sakia	萨迦
sakis	句子
sakti	行为
salal	萨拉尔
salat	沙拉
salep	塞勒普
sales	出售
salet	塞莱特
salic	萨利克
salix	萨利克斯
salle	房间
salmi	三文鱼
salol	萨洛尔
salop	萨洛普
salpa	萨尔帕
salps	萨尔普斯
salse	萨尔塞
salto	跳
salts	盐
salue	敬礼
salut	-嗨。-嗨。
saman	n
samas	同时
samba	桑巴舞
sambo	桑博
samek	全部的
samel	萨梅尔
samen	在一起
sames	萨姆斯
samey	萨米
samfu	桑福
sammy	萨米
sampi	边
sands	沙子
saned	理智的
sanes	理智的
sanga	桑加
sangh	桑
sango	桑戈
sangs	桑斯
sanko	雪橇
sansa	机会
santo	桑托
sants	敏感的
saola	你好
sapan	奶牛
sapid	萨皮德
sapor	风味
saran	萨兰
sards	沙丁油鱼
sared	萨里德
saree	纱丽
sarge	中士
sargo	英语
sarin	沙林
saris	莎丽
sarks	萨尔克
sarky	萨基
sarod	萨罗德
saros	萨罗斯
sarus	莎鲁斯
saser	萨瑟
sasin	萨辛
sasse	石头
satai	100
satay	沙爹
sated	满足
satem	萨特姆
sates	满足
satis	小时
sauba	桑拿
sauch	索奇
saugh	索格
sauls	索尔斯
sault	索尔特
saunt	桑特
saury	辣的
sauts	跳跃
saved	保存的
saver	储户
saves	拯救
savey	萨维
savin	萨文
sawah	无效的
sawed	锯
sawer	锯木匠
saxes	萨克斯人
sayed	测试
sayer	测试
sayid	页面
sayne	测试
sayon	阶段
sayst	塞斯特
sazes	萨克斯人
scabs	结痂
scads	骗局
scaff	流氓
scags	斯卡格斯
scail	规模
scala	斯卡拉
scall	鳞片
scams	诈骗
scand	斯堪的纳维亚
scans	扫描
scapa	逃跑
scape	花茎
scapi	逃跑
scarp	悬崖
scars	疤痕
scart	斯卡特
scath	斯卡特
scats	斯卡茨
scatt	赶快走开
scaud	斯考德
scaup	人渣
scaur	斯古尔
scaws	斯考斯
sceat	skeat
scena	场景
scend	下降
schav	沙夫
schmo	施莫
schul	学校
schwa	施瓦
sclim	斯克里姆
scody	斯科迪
scogs	斯科斯
scoog	史酷格
scoot	快跑
scopa	扫帚
scops	范围
scots	苏格兰人
scoug	Scoug公司
scoup	侦察
scowp	嘲笑
scows	嘲笑
scrab	快滚
scrae	快滚
scrag	快滚
scran	逃走
scrat	快滚
scraw	滚
scray	瘦削的
scrim	斯克里姆
scrip	纸条
scrob	写
scrod	胆小鬼
scrog	吝啬鬼
scrow	吝啬鬼
scudi	盾牌
scudo	盾
scuds	飞毛腿
scuff	磨损
scuft	飞毛腿
scugs	渣滓
sculk	史高克
scull	划桨
sculp	斯库普
sculs	迪克
scums	渣滓
scups	人渣
scurf	头皮屑
scurs	筋疲力竭的
scuse	道歉
scuta	盾
scute	盾牌
scuts	渣滓
scuzz	斯库兹
scyes	对
sdayn	白天
sdein	斯丁
seals	海豹
seame	装置
seams	接缝
seamy	污秽的
seans	会议
seare	傍晚
sears	西尔斯
sease	西丝
seats	座位
seaze	西泽
sebum	皮脂
secco	赛科
sechs	六
sects	教派
seder	莎草
sedes	座位
sedge	莎草
sedgy	塞吉
sedum	景天属
seeds	种子
seeks	寻求
seeld	种子
seels	种子
seely	希利
seems	似乎
seeps	渗出
seepy	渗出的
seers	种子
sefer	塞弗
segar	新鲜的
segni	塞尼
segno	塞格诺
segol	秒
segos	颠倒
sehri	塞赫里
seifs	保险箱
seils	赛尔
seine	围网
seirs	六
seise	站
seism	地震
seity	塞特
seiza	第六
sekos	秒
sekts	秒
selah	分裂
seles	塞莱斯
selfs	自拍
sella	塞拉
selle	它
sells	卖
selva	丛林
semee	照片
semes	精液
semie	半
semis	半决赛
senas	年
sends	发送
senes	西内斯
sengi	森吉
senna	塞纳
senor	先生
sensa	森萨
sensi	感觉
sente	感觉
senti	感觉
sents	美分
senvy	森维
senza	没有
sepad	赛帕德
sepal	萼片
sepic	%s（%s）sepic
sepoy	塞波伊
septa	修女
septs	七分之一
serac	塞拉克
serai	瑟莱
seral	傍晚
sered	塞里德
serer	服务器
seres	众生
serfs	农奴
serge	谢尔盖
seric	塞里奇
serin	丝氨酸
serks	塞克斯
seron	塞朗
serow	塞罗
serra	塞拉
serre	温室
serrs	锁
serry	奶酪
servo	伺服
sesey	塞西
sessa	塞萨
setae	刚毛
setal	塞塔尔
seton	西顿
setts	塞茨
sewan	租金
sewar	下水道
sewed	缝制
sewel	树
sewen	七
sewin	秒
sexed	性爱
sexer	塞克斯
sexes	性别
sexto	第六
sexts	性短信
seyen	秒
shads	鲱鱼
shags	沙格斯
shahs	沙斯
shako	沙科
shakt	棚屋
shalm	沙姆
shaly	泥泞的
shama	萨玛
shams	沙姆
shand	%m/%d/%Y%I:%m:%S%p
shans	掸人
shaps	形状
sharn	矽卡岩
shash	沙什
shaul	沙乌尔
shawm	肖姆
shawn	肖恩
shaws	肖斯
shaya	沙亚
shays	谢斯
sheaf	一捆
sheal	谢尔
sheas	谢斯
sheds	棚
sheel	谢尔
shend	申德
shent	申特
sheol	阴间
sherd	碎片
shere	谢尔
shero	雪罗
shets	谢茨
sheva	舍瓦
shewn	谢恩
shews	展示
shiai	什叶派
shiel	谢尔
shier	希尔
shies	希斯
shill	谢尔
shily	犹豫不决
shims	垫片
shins	小腿
ships	船舶
shirr	谢尔
shirs	西尔斯
shish	嘘
shiso	希索
shist	希斯特
shite	卖
shits	大便
shiur	雨
shiva	湿婆
shive	颤抖
shivs	湿婆
shlub	丛
shmek	施梅克
shmoe	什莫
shoat	嘘
shoed	穿鞋
shoer	肖尔
shoes	鞋
shogi	日本象棋
shogs	鞋
shola	肖拉
shool	学校
shoon	苏
shoos	嘘
shope	商店
shops	商店
shorl	肖尔
shote	射击
shots	镜头
shott	肖特
showd	展示
shows	显示
shoyu	朔禹
shred	切碎
shris	施赖斯
shrow	尖叫
shtik	九月
shtum	施图姆
shule	舒勒
shuln	没有人
shuls	舒尔斯
shuns	回避
shura	舒拉
shute	舒特
shuts	关闭
shwas	施瓦特的
shyer	害羞的
sials	倒霉。
sibyl	女预言家
sices	秒
sicht	看法
sicko	病态的
sicks	生病
sicky	多病的
sidas	页面
sided	站在一边
sider	页面
sides	边
sidha	西达
sidhe	精灵
sidle	悄悄贴近
sield	希尔德
siens	他的
sient	坐
sieth	希思
sieur	西厄
sifts	筛选
sighs	叹息
sigil	密封
sigla	首字母
signa	签名
signs	标志
sijos	西约斯
sikas	西卡人
siker	成功的
sikes	赛克斯
silds	鲱鱼
silen	打开视频设备%s时出错
siler	银
siles	Siles公司
silks	丝绸
sills	窗台
silos	筒仓
silts	淤泥
silty	粉质
silva	席尔瓦
simar	西玛
simas	对
simba	辛巴
simis	猴子
simps	简单的
sinds	自从
sined	肌肉
sines	西内斯
sings	歌唱
sinhs	信义
sinks	下沉
sinky	下沉
sinus	窦
siped	啜饮
sipes	啜饮
sippy	啜饮
sired	父辈
siree	陛下
sires	陛下
sirih	奶酪
siris	叙利亚人
siroc	Siroc
sirra	西拉
sirup	糖浆
sisal	剑麻
sises	里面
sista	最后的
sists	最后的
sitar	锡塔尔
sited	选址
sites	地点
sithe	六
sitka	地点
situp	仰卧起坐
situs	位置
siver	渗出
sixer	76人
sixes	六
sixmo	西斯莫
sixte	十六
sizar	西扎
sized	大小
sizel	大小
sizer	浆纱机
sizes	大小
skags	疼痛
skail	壳
skald	规模
skank	卑鄙的
skart	浪费
skats	视野
skatt	斯卡特
skaws	斯考斯
skean	扫描
skear	分离器
skeds	勺子
skeef	形式
skeen	场景
skeer	分离器
skees	斯凯斯
skeet	飞碟
skegg	影子
skegs	斯凯格斯
skelf	骨架
skell	壳
skelm	柱
skelp	壳
skene	扫描
skens	扫描
skeps	飞碟
skers	斯克斯
skets	斯凯茨
skews	歪斜
skids	滑行
skied	滑雪
skies	天空
skiey	斯凯
skimo	还有滑雪
skims	略过
skink	火腿
skins	皮肤
skint	身无分文的
skios	天空
skips	跳过
skirl	急转弯
skirr	斯基尔
skite	斯基特
skits	短剧
skive	斯奇夫
skivy	机灵的
sklim	斯克里姆
skoal	学校
skody	斯卡德斯
skoff	斯科夫
skogs	森林
skols	学校
skool	学校
skort	缺乏
skosh	斯科什
skran	屏幕
skrik	尖叫
skuas	臭鼬
skugs	臭鼬
skyed	天空
skyer	云
skyey	天空
skyfs	圆盘
skyre	部分
skyrs	天空人
skyte	开枪
slabs	石板
slade	斯莱德
slaes	杀死
slags	熔渣
slaid	滑动
slake	解渴
slams	猛击
slane	旧的
slank	俚语
slaps	拍打
slart	松懈
slats	板条
slaty	石板
slays	杀死
sleds	雪橇
sleer	光滑的
slews	杀死
sleys	斯利
slier	斯莱尔
slily	斯莱利
slims	苗条的
slipe	滑倒
slips	滑倒
slipt	溜走
slish	滑动
slits	裂缝
slive	斯莱夫
sloan	斯隆
slobs	懒汉
sloes	斯洛斯
slogs	艰难
sloid	斯洛伊德
slojd	斯洛德
slomo	慢动作
sloom	蜕皮
sloot	沟
slops	污水
slopy	柱
slorm	懒汉
slots	插槽
slove	斯洛夫
slows	减速
sloyd	斯洛伊德
slubb	Slbb
slubs	竹节
slued	荡妇
slues	荡妇
sluff	软泥
slugs	鼻涕虫
sluit	接近
slums	贫民窟
slurb	咕噜
slurs	诽谤
sluse	接近
sluts	荡妇
slyer	狡猾的
smaak	味道
smaik	味道
smalm	斯马尔
smalt	狭窄的
smarm	斯马尔
smaze	鼠标
smeek	斯梅克
smees	斯梅斯
smeik	微笑。
smeke	斯梅克
smerk	疼痛
smews	抹黑
smirr	微笑
smirs	沙
smits	斯密茨
smogs	烟雾
smoko	无花果
smolt	光滑的
smoor	光
smoot	斯穆特
smore	光滑的
smorg	烟雾
smout	烟雾
smowt	烟雾
smugs	沾沾自喜
smurs	蓝精灵
smush	斯马什
smuts	脏污
snabs	陷阱
snafu	斯纳福
snags	障碍
snaps	猛击
snarf	圈套
snark	打鼾
snars	下一个
snary	圈套
snash	斯诺什
snath	斯内特
snaws	陷阱
snead	星期日
sneap	雪
snebs	斯奈布斯
sneck	斯内克
sneds	SNEDS
sneed	星期日
snees	雪
snell	斯内尔
snibs	狙击手
snick	斯尼克
snies	雪
snift	吝啬鬼
snigs	狙击
snips	剪断
snipy	剪断
snirt	斯奈特
snits	鼻涕
snobs	势利小人
snods	鼻涕
snoek	派克
snoep	糖果
snogs	吻
snoke	斯诺克
snood	斯诺德
snook	斯努克
snool	斯诺尔
snoot	鼻涕
snots	鼻涕
snowk	雪
snows	下雪
snubs	冷落
snugs	鼻烟
snush	溜走
snyes	雪
soaks	浸泡
soaps	肥皂
soare	太阳
soars	硬的
soave	节约
sobas	星期六
socas	袜子
soces	袜子
socko	短袜
socks	袜子
socle	基座
sodas	苏打水
soddy	索迪
sodic	苏打水
sodom	索多玛
sofar	沙发
sofas	沙发
softa	软糖
softs	软糖
softy	柔软的
soger	索格
sohur	播种
soils	土壤
soily	光
sojas	大豆
sojus	大豆
sokah	支持
soken	袜子
sokes	袜子
sokol	学校
solah	索拉
solan	太阳
solas	单一的
solde	余额
soldi	钱
soldo	平衡
solds	索尔兹
soled	鞋底
solei	索莱
soler	太阳
soles	鞋底
solon	太阳
solos	独奏
solum	光
solus	解决
soman	索曼
somas	总数
sonce	太阳
sonde	探空仪
sones	声音
songs	歌曲
sonly	数
sonne	铃声
sonny	桑尼
sonse	桑斯
sonsy	桑西
sooey	苏伊
sooks	性
sooky	乌烟瘴气的
soole	肠
sools	盐
sooms	芬兰语的
soops	抚慰
soote	烟灰
soots	烟灰
sophs	索菲斯
sophy	索菲
sopor	垃圾
soppy	湿漉漉的
sopra	在上面
soral	索拉尔
soras	索拉斯
sorbo	来源
sorbs	索布斯
sorda	聋的
sordo	聋的
sords	伤口
sored	伤口
soree	疮
sorel	索雷尔
sorer	悲哀的
sores	疮
sorex	索雷克斯
sorgo	高粱
sorns	索恩斯
sorra	沙
sorta	类型
sorts	种类
sorus	来源
soths	底部
sotol	索托
souce	声音
souct	声音
sough	呜呜
souks	露天市场
souls	灵魂
soums	苏姆斯
soups	汤
soupy	汤
sours	酸味
souse	酸
souts	苏茨
sowar	索瓦
sowce	绵羊
sowed	播种
sowff	沙发
sowfs	母猪
sowle	索尔
sowls	母猪
sowms	母猪
sownd	索恩德
sowne	奥恩
sowps	汤
sowse	索斯
sowth	播种
soyas	阴影
soyle	索伊尔
soyuz	联盟号
sozin	索津
spacy	空间
spado	斯帕多
spaed	铲
spaer	水疗
spaes	黑桃
spahi	斯帕希
spail	箭头
spain	西班牙
spait	斯派特
spake	说话
spald	斯帕尔德
spale	柱
spall	剥落
spalt	缺口
spams	垃圾
spane	跨度
spang	打屁股
spans	跨越
spard	SPARD公司
spars	桅杆
spart	幸免
spate	一连串
spats	争吵
spaul	水疗中心
spawl	焊接
spaws	垃圾
spayd	斯帕伊德
spays	喷雾
spaza	空间
spazz	斯帕兹
speal	斯帕尔
spean	斯潘
speat	斯佩特
specs	规格
spect	幽灵
speel	游戏
speer	运动员
speil	镜子
speir	斯皮尔
speks	斯佩克斯
speld	斯皮尔德
spelk	游戏
speos	斯佩斯
spets	规格
speug	镜子
spews	喷出
spewy	斯佩维
spial	斯皮尔
spica	斯皮卡
spick	斯派克
spide	插口
spier	肌肉
spies	间谍
spiff	斯皮夫
spifs	SPIFS公司
spiks	斯派克斯
spile	镜子
spims	斯皮姆
spina	脊柱
spink	旋转
spins	旋转
spirt	精神
spiry	斯皮里
spits	吐口水
spitz	斯皮茨
spivs	SPIV
splay	张开
spode	速度
spods	Spods
spoom	恶搞
spoor	斯波尔
spoot	斯普特
spork	斯波克
sposh	斯波什
spots	斑点
sprad	蔓延
sprag	突然出现
sprat	斯普拉特
spred	斯普雷德
sprew	斯普雷夫
sprit	精灵
sprod	发芽
sprog	斯普罗格
sprue	浇口
sprug	弹簧
spuds	土豆
spued	土豆
spuer	斯普尔
spues	土豆
spugs	木桩
spule	吐痰
spume	水沫
spumy	水沫
spurs	马刺队
sputa	斯普塔
spyal	游戏
spyre	呕吐
squab	乳鸽
squaw	呱呱
squeg	挤压
squid	鱿鱼
squit	斜视
squiz	斯奎兹
stabs	刺伤
stade	体育场
stags	牡鹿
stagy	阶段
staig	楼梯
stane	状态
stang	酒吧
staph	葡萄球菌。
staps	斯塔普斯
starn	海星
starr	固执的
stars	星星
stats	统计数据
staun	住手
staws	斯塔斯
stays	停留
stean	斯特恩
stear	明星
stedd	斯特德
stede	地点
steds	STEDS
steek	隐藏
steem	形式
steen	石
steil	陡峭的
stela	斯特拉
stele	石碑
stell	斯特尔
steme	方案
stems	茎
stend	斯滕德
steno	速记
stens	斯滕
stent	支架
steps	台阶
stept	步
stere	明星
stets	斯特茨
stews	炖菜
stewy	炖菜
steys	斯蒂斯
stich	缝线
stied	时间
sties	斯蒂斯
stilb	风格
stile	阶梯
stime	刺激
stims	刺激
stimy	史提米
stipa	针茅
stipe	柄
stire	新闻
stirk	玻璃
stirp	斯蒂普
stirs	搅动
stive	煽动
stivy	斯蒂瓦
stoae	口
stoai	斯托伊
stoas	白鼬
stoat	白鼬
stobs	斯托克斯
stoep	人行道
stogy	结实的
stoit	斯托伊特
stoln	椅子
stoma	气孔
stond	站立
stong	强烈的
stonk	斯托克
stonn	多石的
stook	弯腰
stoor	保管部
stope	采场
stops	停止
stopt	停止
stoss	大便
stots	索陶卫浴
stott	支持
stoun	石头
stoup	上升
stour	斯托尔
stown	斯托恩
stowp	斯托普
stows	积载
strad	斯特拉德
strae	迷路
strag	斯特拉格
strak	紧的
strep	链球菌
strew	撒满
stria	纹
strig	斯特里格
strim	带
strop	斯特罗普
strow	斯特罗
stroy	斯特罗伊
strum	斯特鲁姆
stubs	存根
stude	学习
studs	双头螺栓
stull	壳
stulm	柱
stumm	形式
stums	斯图姆斯
stuns	晕眩
stupa	佛塔
stupe	页脚
sture	斯特尔
sturt	发送
styed	风格
styes	斯蒂斯
styli	风格
stylo	风格
styme	斯泰姆
stymy	闷热的
styre	驾驶
styte	斯泰特
subah	苏巴
subas	爬上
subby	苏比
suber	上升
subha	高的
succi	救援
sucks	烂透了
sucky	糟透了
sucre	糖
sudds	苏迪斯
sudor	汗
sudsy	肥皂泡
suede	山羊皮
suent	声音
suers	汗液
suete	羊毛衫
suets	千斤顶
suety	绒面革
sugan	苏根
sughs	苏格斯
sugos	糖
suhur	温度
suids	起诉
suint	坐
suits	套装
sujee	苏吉
sukhs	苏克斯
sukuk	苏克
sulci	沟
sulfa	磺胺
sulfo	磺基
sulks	生气
sulph	磺酸盐
sulus	苏卢斯
sumis	总和
summa	萨玛
sumos	相扑
sumph	萨姆夫
sumps	污水坑
sunis	太阳
sunks	太阳
sunna	苏娜
sunns	%1克/秒
sunup	日出
supes	苏普斯
supra	上文
surah	苏拉
sural	腓肠肌
suras	苏拉
surat	信
surds	聋的
sured	死亡
sures	南方
surfs	冲浪
surfy	冲浪板
surgy	暴躁的
surra	苏拉
sused	络腮胡子
suses	顶部
susus	苏苏
sutor	缝合线
sutra	经文
sutta	经文
swabs	拭子
swack	斯威克
swads	斯瓦兹
swage	模锻
swags	交换
swail	游泳。
swain	斯温
swale	斯瓦尔
swaly	斯威利
swamy	斯瓦米
swang	斯旺
swank	斯旺克
swans	天鹅
swaps	交换
swapt	游荡
sward	草地
sware	发誓
swarf	切屑
swart	黑色
swats	斯瓦茨
swayl	斯韦尔
sways	摇摆
sweal	斯瓦尔
swede	瑞典人
sweed	咒骂
sweel	斯韦尔
sweer	发誓
swees	瑞典人
sweir	发誓
swelt	世界
swerf	院子
sweys	斯威斯
swies	瑞士人
swigs	痛饮
swile	游泳
swims	游泳
swink	斯温克
swipe	刷卡
swire	太古
swiss	瑞士的
swith	斯威思
swits	游泳
swive	游泳
swizz	嗖嗖
swobs	斯沃布斯
swole	斯沃尔
swoln	肿胀的
swops	猛扑
swopt	猛扑
swots	昏厥
swoun	斯温
sybbe	西比
sybil	西比尔
syboe	锡博
sybow	西博
sycee	赛奇
syces	系统
sycon	西康
syens	梅恩斯
syker	生病的
sykes	赛克斯
sylis	西尔斯
sylph	精灵
sylva	西尔瓦
symar	清楚
synch	同步
syncs	同步
synds	罪
synes	似乎
synth	合成器
syped	赛义德
sypes	赛普斯
syrah	西拉
syren	丁香花
sysop	西索普
sythe	赛特
syver	七
taals	语言文字
taata	保证
taber	失败者
tabes	标签
tabid	塔比德
tabis	标签
tabla	塔布拉
tabor	塔博尔
tabun	桌子
tabus	禁忌语
tacan	塔康
taces	塔克斯
tacet	塔克特
tache	环节
tacho	测速仪
tachs	转速表
tacks	大头钉
tacos	玉米饼
tacts	机智
taels	塔尔
tafia	塔菲亚
taggy	塔吉
tagma	塔格玛
tahas	背景
tahrs	塔尔
taiga	泰加
taigs	塔吉斯
taiko	太子
tails	尾巴
tains	泰恩斯
taira	泰拉
taish	家
taits	泰茨
tajes	塔耶斯
takas	追踪
takes	拿
takhi	塔基
takin	羚牛
takis	塔基斯
takky	杰基
talak	谈话
talaq	塔拉克
talar	讲话
talas	塔拉斯
talcs	滑石粉
talcy	塔西
talea	垃圾桶
taler	演讲
tales	故事
talks	谈话
talky	谈话
talls	塔尔斯
talma	塔尔玛
talpa	鞋底
taluk	塔鲁克
talus	距骨
tamal	塔马尔
tamed	驯服
tames	驯服
tamin	泰米尔人
tamis	泰米尔人
tammy	塔米
tamps	夯实
tanas	塔纳斯
tanga	傻瓜
tangi	唐
tangs	唐
tanhs	晒黑
tanka	坦克
tanks	坦克
tanky	坦克
tanna	坦娜
tansy	坦西
tanti	许多的
tanto	这么多
tanty	阿姨们
tapas	餐前小吃
taped	录音
tapen	磁带
tapes	磁带
tapet	损失
tapis	墙纸
tappa	杀死
tapus	塔普斯
taras	水平
tardo	晚的
tared	皮重
tares	皮重
targa	车牌
targe	塔格
tarns	塔恩斯
taroc	塔洛克
tarok	塔洛克
taros	芋头
tarps	防水布
tarre	柏油
tarry	逗留
tarsi	塔尔西
tarts	馅饼
tarty	馅饼
tasar	塔萨尔
tased	率
taser	泰瑟枪
tases	任务
tasks	任务
tassa	塔萨
tasse	税
tasso	率
tatar	升级
tater	土豆
tates	塔特斯
taths	塔什
tatie	塔蒂
tatou	纹身
tatts	破布
tatus	塔图斯
taube	聋的
tauld	桌子
tauon	陶恩
taupe	灰褐色
tauts	人
tavah	塔瓦
tavas	联系方式
taver	塔弗
tawai	笑
tawas	塔瓦斯
tawed	酒馆
tawer	塔沃
tawie	塔瓦
tawse	塔斯
tawts	瓦茨
taxed	征税
taxer	出租车
taxes	税
taxis	出租车
taxol	紫杉醇
taxon	分类单元
taxor	税务员
taxus	红豆杉
tayra	准备好的
tazza	杯子
tazze	杯子
teade	消息
teads	泰兹
teaed	通知
teaks	知道
teals	水鸭
teams	团队
tears	眼泪
teats	乳头
teaze	蒂泽
techs	技术人员
techy	技术性
tecta	特克塔
teels	牙齿
teems	盛产
teend	青少年
teene	赞成
teens	青少年
teeny	微小的
teers	蒂尔斯
teffs	特弗斯
teggs	特格斯
tegua	隐藏
tegus	行动
tehrs	塔尔
teiid	泰德
teils	泰尔斯
teind	泰因
teins	泰因
telae	肖像画
telco	电信公司
teles	电传
telex	电传系统
telia	泰利亚
telic	泰利克
tells	说明
telly	电视
teloi	泰洛伊
telos	泰洛斯
temed	特梅德
temes	主题
tempi	坦皮
temps	临时工
tempt	引诱
temse	停顿
tench	丹奇
tends	倾向于
tendu	坦杜
tenes	经皮电刺激神经疗法
tenge	腾格
tenia	我有
tenne	田纳西州
tenno	持有
tenny	坦尼
tenon	榫头
tents	帐篷
tenty	这些
tenue	服装
tepal	花被片
tepas	泰普
tepoy	泰波伊
terai	特莱
teras	特拉斯
terce	第三的
terek	特雷克
teres	特雷斯
terfe	结束
terfs	特尔斯
terga	特加
terms	条款
terne	燕鸥
terns	燕鸥
terry	特里
terts	特茨
tesla	特斯拉
testa	种皮
teste	测试
tests	测验
tetes	乳头
teths	特提斯
tetra	四联
tetri	俄罗斯方块
teuch	图什
teugh	是 啊。
tewed	黑色
tewel	但是
tewit	死去的
texas	德克萨斯州
texes	短信
texts	短信
thack	萨克
thagi	泰语
thaim	塞姆
thale	泰雷
thali	塔利
thana	塔纳
thane	塔恩
thang	楼梯
thans	现在
thanx	塔克斯
tharm	塔尔
thars	塔尔
thaws	没想到
thawy	解冻
thebe	提比
theca	卵泡膜
theed	页：1
theek	加上
thees	希斯
thegn	他们
theic	有神论的
thein	内
thelf	塞尔夫
thema	主题
thens	然后
theow	西奥。
therm	特姆
thete	西特
thews	特维斯
thewy	他们
thigs	东西
thilk	蒂尔克
thill	蒂尔
thine	你的
thins	稀薄的
thiol	硫醇
thirl	蒂尔
thoft	托夫特
thole	索尔
tholi	托利
thoro	索罗
thorp	索普
thous	千
thowl	托尔
thrae	色雷斯
thraw	鞭打
thrid	等待。
thrip	蓟马
throe	阵痛。
thuds	砰的一声
thugs	暴徒
thuja	教育类
thunk	砰
thurl	图尔
thuya	图亚
thymi	百里香
thymy	百里香
tians	天书
tiars	头饰
tical	古怪的
ticca	滴答声
ticed	提克
tices	滴答声
tichy	安静的
ticks	滴答声
ticky	痒痒的
tiddy	整洁的
tided	整理
tides	潮汐
tiers	分层
tiffs	争吵
tifos	蒂福斯
tifts	蒂夫茨
tiges	泰格斯
tigon	提贡
tikas	提卡斯
tikes	滴答声
tikis	蒂克
tikka	飞镖
tilak	瓷砖
tiled	瓷砖
tiler	属于
tiles	瓷砖
tills	耕耘
tilly	蒂莉
tilth	倾斜
tilts	倾斜
timbo	廷博
timed	定时的
times	时代
timon	小时
timps	时间
tinas	锡
tinct	廷克
tinds	罐头
tinea	癣
tined	有齿的
tines	尖齿
tinge	少许
tings	廷斯
tinks	叮当声
tinny	微小的
tints	色彩
tinty	浅色的
tipis	类型
tippy	蒂皮
tired	疲倦的
tires	轮胎
tirls	提尔
tiros	枪声
tirrs	蒂尔
titch	滴答声
titer	滴度
titis	标题
titre	标题
titty	乳头
titup	提图普
tiyin	体音
tiyns	tiny s
tizes	经皮电刺激神经疗法
tizzy	提兹
toads	癞蛤蟆
toady	马屁精
toaze	粉红色
tocks	托克斯
tocky	托基
tocos	触碰
todde	托德
toeas	退出。。。
toffs	笨蛋
toffy	太妃糖
tofts	笨蛋
tofus	豆腐
togae	托盖
togas	斗篷
toged	穿着
toges	切换
togue	托格
tohos	托霍斯
toile	帆布
toils	辛劳
toing	托因
toise	其他
toits	食物
tokay	托凯
toked	托克德
toker	托克尔
tokes	托克斯
tokos	托科斯
tolan	托兰
tolar	托拉尔
tolas	托拉斯
toled	托利
toles	全部的
tolls	过路费
tolly	托利
tolts	全部的
tolus	托卢斯
tolyl	甲苯基
toman	采取
tombs	坟墓
tomes	大部头
tomia	番茄学
tommy	汤米
tomos	汤姆斯
tondi	托迪
tondo	色调
toned	调子
toner	爽肤水
tones	音调
toney	吨
tongs	钳子
tonka	吨
tonks	唐克斯
tonne	吨
tonus	吨
tools	工具
tooms	ms
toons	香椿
toots	嘟嘟
toped	顶部
topee	托佩
topek	顶部
toper	托珀
topes	托普斯
tophe	托普
tophi	托菲
tophs	顶部
topis	托皮斯
topoi	拓朴
topos	地形
toppy	顶
toque	玩具
torah	律法
toran	托兰
toras	环面
torcs	托尔茨
tores	塔
toric	复曲面
torii	奥里
toros	托罗斯
torot	托罗
torrs	干的
torse	躯干
torsi	人体躯干
torsk	鳕鱼
torta	蛋糕
torte	侵权行为
torts	侵权行为
tosas	总数
tosed	投掷
toses	托斯
toshy	顶部
tossy	托西
toted	搬运
toter	死去的
totes	手提包
totty	托蒂
touks	土司
touns	图恩斯
tours	旅行
touse	咳嗽
tousy	使用
touts	兜售
touze	欲望
touzy	欲望
towed	拖走
towie	拖
towns	城镇
towny	汤尼
towse	托斯
towsy	托西
towts	托特
towze	托泽
towzy	托齐
toyed	玩弄
toyer	托耶
toyon	Toyon公司
toyos	丰田
tozed	玩弄
tozes	玩弄
tozie	托齐
trabs	特拉布斯
trads	贸易
tragi	特拉吉
traik	特拉克
trams	有轨电车
trank	喝
trans	跨
trant	特朗特
trape	页脚
traps	陷阱
trapt	踢
trass	特拉斯
trats	塔特
tratt	地带
trave	横梁
trayf	托盘
trays	托盘
treck	特雷克
treed	树
treen	火车
trees	树
trefa	树
treif	漂流
treks	长途跋涉
trema	颤抖
trems	颤抖
tress	树
trest	惩罚
trets	特点
trews	树
treyf	崔伊夫
treys	第三的
triac	双向可控硅
tride	三轮车
trier	特里尔
tries	尝试
triff	满足
trigo	小麦
trigs	触发
trike	三轮车
trild	树
trill	颤音
trims	修剪
trine	三合一
trins	步
triol	特里奥。
trior	三
trios	三重奏
trips	旅行
tripy	特里皮
trist	特里斯特
troad	路径
troak	特洛伊
troat	街头
trock	特洛克
trode	三脚架
trods	尽管
trogs	小马
trois	特洛伊
troke	特罗克
tromp	践踏
trona	宝座
tronc	树干
trone	宝座
tronk	特朗克
trons	特朗斯
trooz	三
troth	托斯
trots	小跑
trows	特罗斯
troys	特洛伊
trued	真实的
trues	真的
trugo	大旅行箱
trugs	特鲁格斯
trull	对
tryer	特莱尔。
tryke	印刷
tryma	三
tryps	特里普斯
tsade	沙德
tsadi	之间
tsars	沙皇
tsuba	筑波
tsubo	筑波
tuans	主人
tuart	杜阿尔特
tuath	图阿思
tubae	出口
tubar	塔巴
tubas	大号
tubby	塔比
tubed	管的
tubes	管
tucks	塔克斯
tufas	石灰华
tuffe	浸
tuffs	凝灰岩
tufts	塔夫茨
tufty	丛生的
tugra	图格拉
tuile	瓷砖
tuina	推娜。
tuism	图伊斯主义
tuktu	肥胖的
tules	火
tulpa	塔尔帕
tulsi	图尔西
tumid	坚果
tummy	肚子
tumps	肚子
tumpy	肚子
tunas	金枪鱼
tuned	调谐
tuner	调谐器
tunes	曲调
tungs	激动
tupek	图佩克
tupik	图皮克
tuple	元组
tuque	图克
turds	屎
turfs	草皮
turfy	草皮
turks	土耳其人
turme	塔
turms	团队
turns	转动
turnt	特恩特
turps	头巾
turrs	图尔
tushy	您将离开图形引导菜单并启动文本模式界面。
tusks	象牙
tusky	墨水
tutee	短裙
tutti	图蒂
tutty	塔蒂
tutus	短裙
tuxes	晚礼服
tuyer	杀死
twaes	二
twain	吐温
twals	长的
twank	笨蛋
twats	笨蛋
tways	二
tweel	二
tween	吐温
tweep	特威普
tweer	二
twerk	工作
twerp	笨蛋
twier	特维尔
twigs	树枝
twill	斜纹布
twilt	斜纹布
twink	闪烁
twins	双胞胎
twiny	双胞胎
twire	双重的
twirp	特瑞普
twite	先进的
twits	笨蛋
twoer	两个
twyer	特怀尔
tyees	泰伊
tyers	计时器
tyiyn	泰恩。
tykes	小家伙
tyler	泰勒
tymps	廷普斯
tynde	薄的
tyned	薄的
tynes	薄的
typal	类型
typed	打字
types	类型
typey	类型
typic	典型的
typos	打字错误
typps	类型
typto	典型
tyran	泰拉
tyred	提尔
tyres	轮胎
tyros	蒂罗斯
tythe	泰特
tzars	沙皇
udals	乌达尔
udons	股骨计
ugali	乌加利
ugged	Ugged
uhlan	乌兰
uhuru	乌胡鲁
ulama	乌尔玛
ulans	七月
ulema	乌莱玛
ulmin	乌尔明
ulnad	乌尔纳德
ulnae	乌尔纳
ulnar	尺骨的
ulnas	尺骨
ulpan	乌尔潘
ulvas	狼
ulyie	七月
ulzie	溃疡
umami	母亲
umbel	伞形花序
umber	乌姆
umble	数
umbos	项目
umbre	阴影
umiac	乌米亚克
umiak	分钟
umiaq	乌米亚克
ummah	公众的
ummas	乌玛斯
ummed	嗯
umped	倾销
umphs	嗯
umpie	裁判
umpty	无数
umrah	排
umras	乌姆拉斯
unais	UNAIS公司
unapt	笨拙的
unarm	未武装
unary	一元的
unaus	单元
unbag	解开行李
unbar	安巴尔
unbed	解开
unbid	未绑定
unbox	拆箱
uncap	解开
unces	乌内斯
uncia	盎司
uncos	解开
uncoy	粗俗的
undee	温迪
undos	下载
undug	下载
uneth	不一致
unfix	解开
unget	年轻的
ungot	昂戈
ungum	爪
unhip	取消
unica	独特的
units	单位
unjam	插入
unkid	未知的
unlaw	非法的
unlay	不幸的
unled	未系
unlet	解开
unlid	未点燃
unmew	未提及
unmix	联X特派团
unpay	解开
unpeg	解开
unpen	解开
unpin	解开
unred	未修复
unrid	未解
unrig	解开
unrip	解开
unsaw	取消销售
unsay	不说
unsee	看不见
unsew	未显示
unsex	隐形眼镜
unsod	解除
untin	解开
unwet	未婚
unwit	不明智的
unwon	Unwon
updos	向上
updry	厄普德拉
upend	倒立
upjet	向上喷射
uplay	应用
upled	双倍
uplit	向上
upped	提高
upran	向上攀爬
uprun	自由的
upsee	向上看
upsey	厄西
uptie	向上
uraei	乌莱
urali	乌拉尔
uraos	铀
urare	希望
urari	小时
urase	尿素酶
urate	尿酸盐
urbex	乌贝克斯
urbia	城市
urdee	明天
ureal	乌拉尔
ureas	尿素
uredo	办公室
ureic	尿毒症的
urena	天王星
urent	紧急的
urged	敦促
urger	汉堡
urges	催促
urial	愤怒的
urite	尿道炎
urman	厄尔曼
urnal	乌纳尔
urned	翻
urped	厄普
ursae	熊科
ursid	乌尔都语
urson	厄森
urubu	网络
urvas	乌尔瓦斯
users	用户
usnea	透镜
usque	直到
usure	用户
usury	高利贷
uteri	子宫
uveal	葡萄膜
uveas	葡萄
uvula	悬雍垂
vacua	真空
vaded	吹嘘
vades	脚
vagal	迷走神经的
vagus	迷走神经
vails	韦尔
vaire	更多
vairs	不再
vairy	更多
vakas	西
vakil	真空
vales	山谷
valis	瓦利斯
valse	有效性
vamps	鞋面
vampy	吸血鬼
vanda	万达
vaned	货车
vanes	叶片
vangs	创建一个新列
vants	万特
vaped	抽
vaper	吸血鬼
vapes	吸血鬼
varan	港口
varas	酒吧
vardy	瓦德斯
varec	瓦雷克
vares	商品
varia	瓦里亚
varix	静脉曲张
varna	安全的
varus	内翻
varve	瓦夫
vasal	输精管
vases	花瓶
vasts	巨大的
vasty	浩瀚
vatic	梵蒂冈
vatus	瓦茨
vauch	沃克
vaute	秃鹫
vauts	保险箱
vawte	到期
vaxes	奶牛
veale	错误
veals	小牛
vealy	警觉的
veena	静脉注射
veeps	维普斯
veers	转向
veery	维利
vegas	维加斯
veges	时代
vegie	素食者
vegos	维戈斯
vehme	维姆
veils	面纱
veily	保安
veins	血管
veiny	脉络
velar	贝拉尔
velds	草原
veldt	宽度
veles	韦尔斯
vells	古老的
velum	膜
venae	静脉
venal	贪赃枉法的
vends	小贩
vendu	已售出
veney	维尼
venge	复仇
venin	毒液
vents	通风口
venus	维纳斯
verbs	动词
verra	将
verry	维里
verst	最糟糕的
verts	绿色
vertu	维图
vespa	韦斯帕
vesta	维斯塔
vests	背心
vetch	野豌豆
vexed	烦恼的
vexer	使恼火
vexes	烦恼
vexil	维克西
vezir	视野
vials	小瓶
viand	肉
vibes	共鸣
vibex	振动
vibey	维贝
viced	邪恶的
vices	恶习
vichy	维希
viers	维尔斯。
views	意见
viewy	看法
viffs	毒蛇。
vigas	维吉德
vigia	看
vilde	野生的
viler	维勒
villi	绒毛
vills	错误
vimen	去除
vinal	葡萄酒的
vinas	维纳斯
vinca	绞盘
vined	藤蔓
viner	葡萄酒
vines	藤蔓
vinew	葡萄藤
vinic	乙烯基
vinos	葡萄酒
vints	文茨
viold	紫罗兰色
viols	小提琴
vired	病毒的
vireo	绿巨人
vires	病毒
virga	维加
virge	维姬
virid	绿色的
virls	病毒
virtu	云
visas	签证
vised	虎钳
vises	虎钳
visie	视野
visne	展示
vison	看法
visto	签证
vitae	维泰
vitas	维塔斯
vitex	维泰克斯
vitro	体外培养
vitta	维塔
vivas	万岁
vivat	他还活着
vivda	寡妇
viver	居住
vives	你活着
vizir	维齐尔
vizor	维佐
vleis	弗拉伊斯
vlies	羊毛
voars	沃尔斯
vocab	沃卡布
voces	的声音
voddy	伏特迪
vodou	水
vodun	沃顿
voema	沃玛
vogie	沃基
voids	空隙
voile	帆船
voips	声音
volae	分枝孔板
volar	掌侧
voled	满的
voles	田鼠
volet	田鼠
volks	田鼠
volta	沃尔塔
volte	伏打
volti	面孔
volts	伏特
volva	伏尔瓦
volve	回来
vomer	呕吐者
voted	投票
votes	投票
vouge	Vouge公司
voulu	想要
vowed	发誓
vower	看见
voxel	体素
vozhd	沃兹德
vraic	弗拉克
vrous	弗鲁斯
vrouw	女人
vrows	弗罗
vuggs	空洞
vuggy	多愁善感的
vughs	呜呜
vughy	武吉
vulgo	外阴的
vulva	阴户
vutty	武蒂
waacs	瓦克斯
wacke	怪人
wacko	古怪的
wacks	怪人
wadds	瓦兹
waddy	韦迪
waded	涉水
wader	韦德
wades	韦德斯
wadge	韦奇
wadis	瓦迪斯
wadts	瓦茨
waffs	瓦夫
wafts	飘荡
waged	打赌
wages	工资
wagga	马车
wagyu	和牛
wahoo	哇！
waide	韦德
waifs	流浪汉
waift	英尺
wails	哀号
wains	流浪汉
wairs	哭泣。
waite	韦特
waits	等待
wakas	时间
waked	醒来
waken	醒来
waker	唤醒者
wakes	唤醒
waldo	金
walds	瓦尔兹
waled	横档
waler	沃勒
wales	威尔士
walie	阀门
walis	瓦利斯
walks	走
walla	瓦拉
walls	墙
wally	沃利
walty	紫罗兰
wames	皇玛士
wamus	瓦姆斯
wands	魔杖
waned	减弱
wanes	减弱
waney	“瓦尼”
wangs	王氏
wanks	笨蛋
wanky	放荡的
wanle	带来给你的是：
wanly	只是
wanna	想要
wants	欲望
wanty	万特
wanze	衰落
waqfs	停止
warbs	温暖
warby	沃比
wards	病房
wared	警惕的
wares	商品
warez	瓦雷斯
warks	工作
warms	温暖
warns	警告
warps	扭曲
warre	沃伦
warst	战争
warts	疣
wases	天
washy	苍白的
wasms	天
wasps	黄蜂
waspy	马屁精
wasts	黄蜂
watap	瓦茨
watts	瓦茨
wauff	沃夫
waugh	哇
wauks	停顿
waulk	对
wauls	沃尔斯
waurs	沃尔斯
waved	挥手
waves	波浪
wavey	韦维
wawas	瓦瓦斯
wawes	瓦韦斯
wawls	哇哇
waxed	上蜡
waxer	打蜡机
waxes	蜡
wayed	_其他组织者
wazir	瓦齐尔
wazoo	瓦祖
weald	维尔德
weals	坏处
weamb	懦夫
weans	断奶
wears	穿
webby	韦比
weber	韦伯
wecht	弱点
wedel	天气
wedgy	楔形的
weeds	杂草
weeke	周
weeks	周
weels	韦尔斯
weems	维姆斯
weens	维恩斯
weeny	小家伙
weeps	哭泣
weepy	哭泣的
weest	最甜的
weete	威特
weets	威茨
wefte	头衔
wefts	纬纱
weids	延长
weils	韦尔
weirs	堰
weise	明智的
weize	小麦
wekas	韦卡斯
welds	焊缝
welke	哪一个
welks	其中
welkt	哪一个
wells	威尔斯
welly	嗯。
welts	世界
wembs	韦姆斯
wends	温兹
wenge	文革
wenny	温妮
wents	温茨
weros	维罗斯
wersh	赖特
wests	西
wetas	韦塔斯
wetly	潮湿的
wexed	哭泣
wexes	韦克斯
whang	黄
whaps	重击
whare	家
whata	缩小
whats	什么
whaup	怎么了
whaur	什么
wheal	风团
whear	小麦
wheen	小麦
wheep	呼
wheft	磨蹭
whelk	青春痘
whelm	呼噜声
whens	何时
whets	磨
whews	轮辐
wheys	Wheys
whids	权贵
whift	抽打
whigs	辉格党
whilk	抽打
whims	突发奇想
whins	Whins
whios	呼呼
whips	鞭子
whipt	呜咽
whirr	呼呼
whirs	呼呼
whish	呼呼的声音
whiss	惠斯
whist	惠斯特
whits	白色的
whity	白色
whizz	嗖嗖
whomp	砰
whoof	哇
whoot	哇
whops	哇
whore	妓女
whorl	螺纹
whort	妓女
whoso	哇
whows	哇
whump	胡姆普
whyda	维达
wicca	巫术崇拜
wicks	灯芯
wicky	邪恶的
widdy	小部件
wides	宽度
wiels	维尔
wifed	瘦削的
wifes	妻子
wifey	妻子
wifie	改变
wifty	威夫茨
wigan	维根
wigga	行为举止或衣着貌似黑人的白人
wiggy	假发
wikis	维客
wilco	狼
wilds	荒野
wiled	诡计
wiles	诡计
wilga	威尔加
wilis	威利斯
wilja	智利
wills	遗嘱
wilts	枯萎病
wimps	懦夫
winds	风
wined	葡萄酒
wines	葡萄酒
winey	酒的
winge	翼子板
wings	翅膀
wingy	翅膀的
winks	眨眼
winna	温娜
winns	温恩斯
winos	酒鬼
winze	温兹
wiped	抹去
wiper	雨刮器
wipes	抹布
wired	有线
wirer	电线工
wires	电线
wirra	威拉
wised	明智的
wises	智者
wisha	维沙
wisht	希望
wisps	一缕
wists	威斯特
witan	维坦
wited	白色
wites	才智
withe	维特
withs	具有
withy	维西
wived	维德
wiver	维弗
wives	妻子
wizen	重量
wizes	大小
woads	哇
woald	来吧。
wocks	哇
wodge	沃奇
woful	好极了
wojus	沃朱斯
woker	沃克
wokka	沃卡
wolds	世界
wolfs	狼
wolly	缓慢地
wolve	沃尔夫
wombs	子宫
womby	沃比
womyn	女人
wonga	旺加
wongi	旺吉
wonks	书呆子
wonky	古怪的
wonts	习惯
woods	树林
wooed	求爱
woofs	求爱
woofy	昏昏欲睡
woold	树林
wools	羊毛衫
woons	住宅的
woops	呜呜声
woopy	糟糕的
woose	沃斯
woosh	哇
wootz	伍兹
words	话
works	作品
worms	虫子
wormy	虫子
worts	话
wowed	惊叹
wowee	哇
woxen	沃克森
wrang	雷恩
wraps	包裹
wrapt	白色太空包
wrast	愤怒
wrate	写
wrawl	四月
wrens	鹪鹩
wrick	扭动
wried	拧
wrier	赖尔
wries	赖斯
writs	令状
wroke	Wroke
wroot	Wroot
wroth	大门
wryer	沃耶
wuddy	乌迪
wudus	乌杜斯
wulls	二重的
wurst	香肠
wuses	胆小鬼
wushu	武术
wussy	胆小鬼
wuxia	武侠
wyled	怀尔德
wyles	怀尔斯
wynds	死胡同
wynns	温恩斯
wyted	白色
wytes	白色
xebec	塞贝克
xenia	天才
xenon	氙气
xeric	旱生
xerox	施乐
xerus	施乐斯
xoana	没有
xrays	X光
xylan	木聚糖
xylem	木质部
xylic	木糖的
xylol	二甲苯
xylyl	二甲苯基
yaars	小时
yabas	标签
yabba	标签
yabby	标签
yacca	游艇
yacka	雅卡
yacks	哎呀
yaffs	雅芙
yager	旅行者
yages	雅格
yagis	对
yahoo	雅虎
yaird	院子
yakka	全部的
yakow	雅科
yales	雅尔
yamen	衙门
yampy	山猫
yamun	亚蒙
yangs	杨斯
yanks	美国佬
yapok	还不够
yapon	亚彭
yapps	雅普斯
yappy	哈皮
yarak	伤口
yarco	雅科
yards	码
yarer	箭
yarfa	星期日
yarks	亚克斯
yarns	纱线
yarrs	亚尔斯
yarta	雅特
yates	尤特斯
yauds	尤兹
yauld	雅尔
yaups	打哈欠
yawed	打哈欠
yawey	耶
yawls	哈欠
yawns	打哈欠
yawny	哈欠的
yawps	哈欠
ybore	伊博
yclad	伊克拉德
ycled	Ycled
ydrad	半径
ydred	伊德雷德
yeads	叶芝
yeahs	是的。
yealm	耶尔姆
yeard	伊尔德
years	年
yecch	是的
yechs	是的
yechy	链接
yedes	七
yeeds	西部的
yeesh	新的
yeggs	是的
yelks	耶尔斯
yells	喊叫
yelms	耶姆斯
yelps	尖叫声
yelts	喊叫
yenta	延塔
yente	其他的
yerba	评级
yerds	耶兹
yerks	耶克斯
yeses	是的
yests	是的
yesty	易怒的
yetis	雪人
yetts	是的
yeuks	尤克斯
yeuky	尤基
yeven	耶文
yeves	七
yewen	六月
yexed	是的
yexes	句号
yfere	伊弗尔
yiked	哎呀
yikes	哎呀
yills	语言
yince	开关
yipes	哎呀
yippy	哎呀
yirds	耶尔德
yirks	耶克斯
yirrs	耶尔斯
yirth	线
yites	字节
yitie	一铁
ylems	伊莱姆斯
ylike	结束
ylkes	伊尔克斯
ymolt	伊莫尔特
yobby	优比
yocks	哎呀
yodel	尤德尔
yodhs	尤德
yodle	尤德尔
yogas	瑜珈士
yogee	Yogee
yoghs	瑜伽士
yogic	瑜伽的
yogin	Yogin
yogis	瑜伽士
yoick	哎呀
yojan	约扬
yoked	束缚
yokel	乡巴佬
yoker	约克
yokes	轭
yokul	属于
yolks	蛋黄
yolky	蛋黄
yomim	尤米姆
yomps	流氓
yonic	尤尼克
yonis	尤尼斯
yonks	没有人
yoofs	约夫斯
yoops	哟
yores	约尔
yorks	约克人
yorps	约普斯
youks	尤克斯
yourn	你好。
yours	你的
yourt	你不是
youse	尤斯
yowed	Yowed
yowes	哟
yowie	尤维
yowls	嚎叫
yowza	天呐
yrapt	伊拉普
yrent	伊伦特
yrivd	伊里夫
yrneh	伊尔内
ysame	伊萨梅
ytost	伊托斯特
yuans	元
yucas	尤卡斯
yucca	尤卡
yucch	尤奇
yucko	恶心
yucks	恶心
yucky	恶心
yufts	尤夫茨
yugas	七月
yuked	爱抚
yukes	尤克斯
yukky	尤基
yukos	尤科斯
yulan	玉兰
yules	圣诞节
yummy	好吃的
yumps	蒙古包
yupon	尤邦
yuppy	雅皮士！
yurta	昨天
yurts	蒙古包
yuzus	尤祖斯
zabra	萨布拉
zacks	扎克
zaida	周
zaidy	扎伊德
zaire	扎伊尔
zakat	扎卡特
zaman	扎曼
zambo	赞波
zamia	扎米亚
zanja	取消
zante	下一个
zanza	赞扎
zanze	赞泽
zappy	扎皮
zarfs	扎尔斯
zaris	扎里斯
zatis	扎蒂斯
zaxes	扎克斯
zayin	杂音
zazen	关闭
zeals	热情
zebec	泽贝克
zebub	泽布
zebus	泽布斯
zedas	泽达斯
zeins	中国人
zendo	岑多
zerda	泽达
zerks	虫子
zeros	零
zests	热情
zetas	齐塔人
zexes	十
zezes	泽兹
zhomo	佐莫
zibet	九
ziffs	数字
zigan	自甘
zilas	齐拉斯
zilch	废话
zilla	齐拉
zills	齐尔
zimbi	辛比
zimbs	齐布斯
zinco	锌
zincs	锌
zincy	津西
zineb	锌
zines	吉尼斯
zings	津格斯
zingy	角
zinke	全部
zinky	锌
zippo	齐波
zippy	活泼的
ziram	齐拉姆
zitis	青春痘
zizel	违约
zizit	低的
zlote	兹洛特
zloty	兹罗蒂
zoaea	佐亚
zobos	佐伯斯
zobus	牙齿
zocco	佐科
zoeae	佐伊
zoeal	佐伊尔
zoeas	佐亚斯
zombi	两者都有
zonae	地区
zonda	巽他
zoned	分区
zoner	区域；
zones	区域
zonks	宗克
zooea	动物园
zooey	柔伊
zooid	动物
zooks	放大
zooms	缩放
zoons	儿子们
zooty	动物园
zoppa	佐帕
zoppo	瘸的
zoril	成熟的
zoris	佐里斯
zorro	狐狸
zouks	祖克斯
zowee	佐维
zowie	是
zulus	祖鲁
zupan	祖潘
zupas	双重的
zuppa	汤
zurfs	祖尔夫
zuzim	变焦
zygal	齐格尔
zygon	Zygon公司
zymes	酶
zymic	发酵的
